County, State, FIPS Code, Total Pop, Median Income ($), No. of Housing Units, Median Home Value ($), No. of Owner Occupied Housing Units, No. of Owner Occ. Housing Units with Debt, No. of Owner Occ. Housing Units without Debt
Autauga County, Alabama, 01001, 55221, 51281, 22582, 141300, 15077, 9668, 5409
Baldwin County, Alabama, 01003, 195121, 50254, 106422, 169300, 52997, 31824, 21173
Barbour County, Alabama, 01005, 26932, 32964, 11810, 92200, 5864, 2691, 3173
Bibb County, Alabama, 01007, 22604, 38678, 8971, 102700, 5278, 2605, 2673
Blount County, Alabama, 01009, 57710, 45813, 23860, 119800, 16423, 8849, 7574
Bullock County, Alabama, 01011, 10678, 31938, 4465, 68600, 2609, 866, 1743
Butler County, Alabama, 01013, 20354, 32229, 9919, 78900, 5644, 2348, 3296
Calhoun County, Alabama, 01015, 116648, 41703, 53296, 105900, 31179, 16611, 14568
Chambers County, Alabama, 01017, 34079, 34177, 16936, 80800, 9318, 4847, 4471
Cherokee County, Alabama, 01019, 26008, 36296, 16242, 105100, 8761, 3978, 4783
Chilton County, Alabama, 01021, 43819, 41627, 19247, 100100, 12410, 6309, 6101
Choctaw County, Alabama, 01023, 13395, 33536, 7232, 61100, 4547, 1606, 2941
Clarke County, Alabama, 01025, 25070, 32011, 12600, 86900, 6372, 2448, 3924
Clay County, Alabama, 01027, 13537, 35327, 6738, 84100, 4029, 1847, 2182
Cleburne County, Alabama, 01029, 15002, 38056, 6692, 108000, 4470, 1968, 2502
Coffee County, Alabama, 01031, 50884, 46729, 22776, 142400, 12960, 7059, 5901
Colbert County, Alabama, 01033, 54444, 40576, 26068, 99400, 15833, 8463, 7370
Conecuh County, Alabama, 01035, 12865, 24900, 7070, 70100, 3992, 1005, 2987
Coosa County, Alabama, 01037, 11027, 31212, 6462, 78300, 3530, 1598, 1932
Covington County, Alabama, 01039, 37886, 36444, 18773, 93600, 11171, 5170, 6001
Crenshaw County, Alabama, 01041, 13938, 36022, 6703, 70600, 3787, 1645, 2142
Cullman County, Alabama, 01043, 80965, 38971, 37103, 115200, 23548, 13245, 10303
Dale County, Alabama, 01045, 49866, 45028, 22822, 101700, 11792, 6612, 5180
Dallas County, Alabama, 01047, 42154, 27306, 20243, 81500, 9658, 4746, 4912
DeKalb County, Alabama, 01049, 71068, 38192, 31058, 98500, 18322, 9083, 9239
Elmore County, Alabama, 01051, 80763, 53555, 33140, 147500, 21453, 14152, 7301
Escambia County, Alabama, 01053, 37935, 32330, 16435, 93800, 9774, 3788, 5986
Etowah County, Alabama, 01055, 103766, 39220, 47500, 100400, 28472, 14954, 13518
Fayette County, Alabama, 01057, 16896, 34680, 8415, 75200, 5212, 2051, 3161
Franklin County, Alabama, 01059, 31634, 35372, 14030, 85600, 8097, 3865, 4232
Geneva County, Alabama, 01061, 26815, 36024, 12658, 77400, 8043, 3526, 4517
Greene County, Alabama, 01063, 8697, 20541, 4994, 69600, 2275, 687, 1588
Hale County, Alabama, 01065, 15256, 32714, 7641, 87400, 4466, 2033, 2433
Henry County, Alabama, 01067, 17252, 41997, 8960, 96300, 5398, 2907, 2491
Houston County, Alabama, 01069, 103534, 41571, 46097, 123300, 25359, 15015, 10344
Jackson County, Alabama, 01071, 52860, 37745, 24758, 98900, 15025, 6843, 8182
Jefferson County, Alabama, 01073, 659026, 45610, 303755, 143400, 164894, 106912, 57982
Lamar County, Alabama, 01075, 14133, 35450, 7314, 67900, 4397, 1584, 2813
Lauderdale County, Alabama, 01077, 92737, 43125, 44158, 118600, 26757, 14710, 12047
Lawrence County, Alabama, 01079, 33586, 40003, 15190, 94800, 10845, 5065, 5780
Lee County, Alabama, 01081, 150982, 44570, 64964, 154300, 33753, 21594, 12159
Limestone County, Alabama, 01083, 88805, 49570, 35357, 142100, 24570, 15154, 9416
Lowndes County, Alabama, 01085, 10742, 25876, 5091, 67800, 3154, 1386, 1768
Macon County, Alabama, 01087, 20018, 30738, 10238, 74700, 5203, 2276, 2927
Madison County, Alabama, 01089, 346438, 57993, 152720, 167900, 93319, 64146, 29173
Marengo County, Alabama, 01091, 20306, 32042, 10218, 90800, 5809, 2694, 3115
Marion County, Alabama, 01093, 30387, 32299, 14724, 81400, 9595, 4030, 5565
Marshall County, Alabama, 01095, 94318, 38983, 40370, 115500, 24605, 13593, 11012
Mobile County, Alabama, 01097, 414251, 43809, 180932, 122400, 102608, 63420, 39188
Monroe County, Alabama, 01099, 22217, 27257, 11296, 81200, 5561, 2436, 3125
Montgomery County, Alabama, 01101, 228138, 44369, 103070, 122300, 53006, 36131, 16875
Morgan County, Alabama, 01103, 119786, 45751, 51411, 123500, 32710, 19019, 13691
Perry County, Alabama, 01105, 10038, 24537, 4711, 66300, 2364, 840, 1524
Pickens County, Alabama, 01107, 19856, 30330, 9447, 82000, 5486, 2423, 3063
Pike County, Alabama, 01109, 33155, 32825, 15619, 105500, 7411, 3793, 3618
Randolph County, Alabama, 01111, 22648, 36924, 11940, 85800, 6353, 2890, 3463
Russell County, Alabama, 01113, 58302, 37049, 26368, 111000, 13071, 8266, 4805
St. Clair County, Alabama, 01115, 85864, 51859, 35741, 140000, 25631, 15100, 10531
Shelby County, Alabama, 01117, 203530, 70187, 82850, 192800, 59588, 42948, 16640
Sumter County, Alabama, 01119, 13341, 19501, 6752, 72900, 3269, 1284, 1985
Talladega County, Alabama, 01121, 81437, 35155, 37157, 93400, 22329, 11254, 11075
Tallapoosa County, Alabama, 01123, 41153, 39206, 22078, 103400, 11649, 6031, 5618
Tuscaloosa County, Alabama, 01125, 200458, 46565, 87064, 156500, 44160, 28883, 15277
Walker County, Alabama, 01127, 65923, 35843, 30673, 82800, 18943, 8019, 10924
Washington County, Alabama, 01129, 16997, 42811, 8371, 85700, 5147, 2037, 3110
Wilcox County, Alabama, 01131, 11235, 23750, 5616, 77300, 2645, 862, 1783
Winston County, Alabama, 01133, 24130, 33194, 13416, 81500, 7168, 2926, 4242
Aleutians East Borough, Alaska, 02013, 3304, 61518, 894, 126100, 369, 134, 235
Aleutians West Census Area, Alaska, 02016, 5684, 84306, 1944, 217500, 367, 205, 162
Anchorage Municipality, Alaska, 02020, 299107, 78326, 114083, 290500, 63120, 46153, 16967
Bethel Census Area, Alaska, 02050, 17776, 51012, 5937, 165700, 2898, 1054, 1844
Bristol Bay Borough, Alaska, 02060, 970, 79750, 917, 187500, 204, 93, 111
Denali Borough, Alaska, 02068, 2060, 81544, 1724, 190200, 513, 234, 279
Dillingham Census Area, Alaska, 02070, 4979, 54173, 2422, 195100, 813, 290, 523
Fairbanks North Star Borough, Alaska, 02090, 99705, 71068, 41697, 218100, 20677, 14256, 6421
Haines Borough, Alaska, 02100, 2560, 58750, 1590, 211400, 812, 450, 362
Hoonah-Angoon Census Area, Alaska, 02105, 2128, 52419, 1661, 233400, 591, 202, 389
Juneau City and Borough, Alaska, 02110, 32531, 85746, 13159, 323500, 7711, 5484, 2227
Kenai Peninsula Borough, Alaska, 02122, 57221, 63684, 30671, 219100, 15566, 9129, 6437
Ketchikan Gateway Borough, Alaska, 02130, 13699, 64222, 6220, 252500, 3096, 2032, 1064
Kodiak Island Borough, Alaska, 02150, 13973, 70887, 5320, 245400, 2750, 1756, 994
Kusilvak Census Area, Alaska, 02158, 7914, 38229, 2193, 108000, 1294, 366, 928
Lake and Peninsula Borough, Alaska, 02164, 1474, 50781, 1508, 145000, 322, 73, 249
Matanuska-Susitna Borough, Alaska, 02170, 96178, 72983, 41311, 224900, 23533, 16344, 7189
Nome Census Area, Alaska, 02180, 9854, 48868, 4025, 123500, 1649, 702, 947
North Slope Borough, Alaska, 02185, 9667, 72576, 2520, 141100, 1050, 376, 674
Northwest Arctic Borough, Alaska, 02188, 7732, 63648, 2711, 124500, 1060, 382, 678
Petersburg Borough, Alaska, 02195, 3221, 67935, 1738, 218800, 864, 466, 398
Prince of Wales-Hyder Census Area, Alaska, 02198, 6376, 48523, 3334, 162600, 1625, 547, 1078
Sitka City and Borough, Alaska, 02220, 8943, 70376, 4119, 338600, 2056, 1144, 912
Skagway Municipality, Alaska, 02230, 999, 69318, 636, 324600, 223, 146, 77
Southeast Fairbanks Census Area, Alaska, 02240, 7029, 62670, 3909, 197300, 1485, 496, 989
Valdez-Cordova Census Area, Alaska, 02261, 9617, 78810, 6093, 200700, 2125, 975, 1150
Wrangell City and Borough, Alaska, 02275, 2387, 48603, 1499, 171400, 745, 324, 421
Yakutat City and Borough, Alaska, 02282, 643, 72500, 391, 166000, 136, 67, 69
Yukon-Koyukuk Census Area, Alaska, 02290, 5644, 38491, 4035, 88800, 1402, 221, 1181
Apache County, Arizona, 04001, 72124, 31757, 32661, 83300, 14755, 3854, 10901
Cochise County, Arizona, 04003, 129647, 45075, 60087, 143900, 33186, 18956, 14230
Coconino County, Arizona, 04005, 136701, 50234, 63955, 219300, 27868, 15655, 12213
Gila County, Arizona, 04007, 53165, 39751, 32952, 134200, 15209, 6860, 8349
Graham County, Arizona, 04009, 37407, 45964, 13128, 123300, 7752, 4346, 3406
Greenlee County, Arizona, 04011, 9023, 51628, 4399, 82700, 1493, 529, 964
La Paz County, Arizona, 04012, 20335, 34466, 16104, 69100, 6972, 1746, 5226
Maricopa County, Arizona, 04013, 4018143, 54229, 1668555, 187100, 875327, 623472, 251855
Mohave County, Arizona, 04015, 203362, 38488, 111984, 123200, 54220, 28821, 25399
Navajo County, Arizona, 04017, 107656, 35921, 57414, 104400, 23882, 9249, 14633
Pima County, Arizona, 04019, 998537, 46162, 446769, 159900, 238329, 152676, 85653
Pinal County, Arizona, 04021, 389772, 49477, 163490, 128700, 92151, 57000, 35151
Santa Cruz County, Arizona, 04023, 47073, 40140, 18105, 137000, 10137, 6820, 3317
Yavapai County, Arizona, 04025, 215996, 44748, 111731, 188200, 64499, 37108, 27391
Yuma County, Arizona, 04027, 202987, 40743, 89330, 112100, 48081, 27770, 20311
Arkansas County, Arkansas, 05001, 18731, 36411, 9444, 75600, 5166, 2534, 2632
Ashley County, Arkansas, 05003, 21229, 34263, 10104, 65700, 6290, 2605, 3685
Baxter County, Arkansas, 05005, 41040, 35396, 22613, 120400, 13726, 7008, 6718
Benton County, Arkansas, 05007, 238198, 56239, 96389, 150800, 57386, 39591, 17795
Boone County, Arkansas, 05009, 37227, 39251, 16902, 111700, 10651, 5795, 4856
Bradley County, Arkansas, 05011, 11206, 33701, 5832, 68700, 3102, 1337, 1765
Calhoun County, Arkansas, 05013, 5245, 36899, 2889, 69000, 1700, 546, 1154
Carroll County, Arkansas, 05015, 27635, 36897, 13561, 116200, 8297, 4094, 4203
Chicot County, Arkansas, 05017, 11353, 28913, 5404, 57300, 3053, 1078, 1975
Clark County, Arkansas, 05019, 22751, 35031, 10392, 87200, 5511, 2466, 3045
Clay County, Arkansas, 05021, 15400, 32552, 8046, 63900, 4858, 2018, 2840
Cleburne County, Arkansas, 05023, 25711, 42905, 15841, 126500, 7735, 3759, 3976
Cleveland County, Arkansas, 05025, 8510, 43158, 4054, 84700, 2616, 978, 1638
Columbia County, Arkansas, 05027, 24327, 36619, 11572, 79000, 6544, 2960, 3584
Conway County, Arkansas, 05029, 21110, 37732, 9725, 91500, 6100, 3072, 3028
Craighead County, Arkansas, 05031, 101409, 42475, 42600, 129700, 22887, 14569, 8318
Crawford County, Arkansas, 05033, 61748, 41268, 26378, 108600, 18146, 10826, 7320
Crittenden County, Arkansas, 05035, 49765, 38004, 21568, 104600, 10499, 6869, 3630
Cross County, Arkansas, 05037, 17467, 38103, 7871, 82400, 4426, 2319, 2107
Dallas County, Arkansas, 05039, 7868, 34084, 4300, 62000, 2144, 853, 1291
Desha County, Arkansas, 05041, 12379, 27197, 6269, 59300, 3030, 1114, 1916
Drew County, Arkansas, 05043, 18740, 32819, 8478, 93600, 4443, 2014, 2429
Faulkner County, Arkansas, 05045, 119343, 51223, 48478, 146100, 27292, 18595, 8697
Franklin County, Arkansas, 05047, 17866, 39285, 8024, 93100, 4818, 2436, 2382
Fulton County, Arkansas, 05049, 12224, 37066, 6770, 96700, 4016, 2115, 1901
Garland County, Arkansas, 05051, 96954, 38733, 50518, 130700, 27113, 14817, 12296
Grant County, Arkansas, 05053, 18054, 46171, 7820, 108300, 5305, 2630, 2675
Greene County, Arkansas, 05055, 43382, 41286, 18327, 107700, 10787, 5877, 4910
Hempstead County, Arkansas, 05057, 22336, 32122, 10424, 74700, 5300, 2268, 3032
Hot Spring County, Arkansas, 05059, 33316, 40000, 14293, 83300, 8734, 4205, 4529
Howard County, Arkansas, 05061, 13555, 34229, 6233, 83900, 3299, 1430, 1869
Independence County, Arkansas, 05063, 36952, 36265, 16248, 96000, 10167, 5599, 4568
Izard County, Arkansas, 05065, 13480, 32630, 7209, 78000, 4336, 1980, 2356
Jackson County, Arkansas, 05067, 17597, 31261, 7585, 60600, 4310, 1985, 2325
Jefferson County, Arkansas, 05069, 73548, 36747, 33161, 82000, 17989, 9705, 8284
Johnson County, Arkansas, 05071, 25930, 34139, 11334, 89900, 7204, 3537, 3667
Lafayette County, Arkansas, 05073, 7270, 31194, 4353, 61400, 2033, 824, 1209
Lawrence County, Arkansas, 05075, 17029, 32379, 7981, 64500, 4713, 2041, 2672
Lee County, Arkansas, 05077, 9966, 28393, 4370, 59500, 2051, 660, 1391
Lincoln County, Arkansas, 05079, 14062, 32580, 4857, 59600, 2817, 1084, 1733
Little River County, Arkansas, 05081, 12720, 36205, 6454, 75500, 3860, 1474, 2386
Logan County, Arkansas, 05083, 22001, 35325, 10133, 83200, 6336, 2980, 3356
Lonoke County, Arkansas, 05085, 70691, 53631, 28253, 126900, 18237, 12396, 5841
Madison County, Arkansas, 05087, 15702, 37691, 7483, 96100, 4825, 2118, 2707
Marion County, Arkansas, 05089, 16458, 34195, 9333, 102900, 5294, 2760, 2534
Miller County, Arkansas, 05091, 43652, 40317, 19375, 94600, 10922, 5192, 5730
Mississippi County, Arkansas, 05093, 44864, 34612, 20512, 79600, 9870, 5428, 4442
Monroe County, Arkansas, 05095, 7713, 27647, 4437, 55000, 2083, 811, 1272
Montgomery County, Arkansas, 05097, 9197, 33037, 5746, 82200, 3099, 1222, 1877
Nevada County, Arkansas, 05099, 8793, 30691, 4553, 66600, 2471, 1012, 1459
Newton County, Arkansas, 05101, 8052, 34536, 4679, 82900, 2788, 1026, 1762
Ouachita County, Arkansas, 05103, 25044, 31293, 13089, 66400, 7066, 2907, 4159
Perry County, Arkansas, 05105, 10300, 42346, 4904, 84200, 3074, 1334, 1740
Phillips County, Arkansas, 05107, 20391, 26844, 10136, 61200, 4170, 1756, 2414
Pike County, Arkansas, 05109, 11087, 33097, 5578, 74700, 3295, 1537, 1758
Poinsett County, Arkansas, 05111, 24210, 33070, 10920, 74200, 5721, 2422, 3299
Polk County, Arkansas, 05113, 20364, 33702, 10038, 84300, 6252, 2872, 3380
Pope County, Arkansas, 05115, 62830, 39810, 25789, 117100, 15305, 8835, 6470
Prairie County, Arkansas, 05117, 8402, 35833, 4497, 66400, 2700, 1048, 1652
Pulaski County, Arkansas, 05119, 390463, 46140, 179916, 142400, 92876, 61361, 31515
Randolph County, Arkansas, 05121, 17695, 34044, 8521, 73700, 5362, 2668, 2694
St. Francis County, Arkansas, 05123, 27345, 32105, 10915, 60800, 5247, 2599, 2648
Saline County, Arkansas, 05125, 113833, 55817, 46355, 141400, 32556, 20748, 11808
Scott County, Arkansas, 05127, 10870, 37321, 5191, 76800, 3010, 1472, 1538
Searcy County, Arkansas, 05129, 7965, 33083, 4901, 86300, 2559, 915, 1644
Sebastian County, Arkansas, 05131, 127273, 38575, 55758, 114600, 30104, 18408, 11696
Sevier County, Arkansas, 05133, 17268, 36579, 6878, 68200, 4403, 2130, 2273
Sharp County, Arkansas, 05135, 17055, 30691, 9825, 74800, 5512, 2782, 2730
Stone County, Arkansas, 05137, 12512, 29264, 6737, 92700, 3904, 1623, 2281
Union County, Arkansas, 05139, 40633, 38678, 19641, 74600, 11724, 5227, 6497
Van Buren County, Arkansas, 05141, 17002, 32312, 10329, 89900, 5287, 2159, 3128
Washington County, Arkansas, 05143, 216432, 43524, 89331, 151900, 44668, 29879, 14789
White County, Arkansas, 05145, 78660, 42554, 32970, 108800, 20158, 11227, 8931
Woodruff County, Arkansas, 05147, 6983, 28993, 3883, 60000, 1785, 680, 1105
Yell County, Arkansas, 05149, 21835, 37804, 9739, 94900, 5195, 2574, 2621
Alameda County, California, 06001, 1584983, 75619, 589858, 543100, 294644, 221569, 73075
Alpine County, California, 06003, 1131, 52917, 1801, 295000, 282, 151, 131
Amador County, California, 06005, 36995, 54171, 18184, 251000, 10577, 6360, 4217
Butte County, California, 06007, 222564, 43444, 97133, 221700, 50031, 31251, 18780
Calaveras County, California, 06009, 44767, 53233, 28031, 243800, 14266, 9243, 5023
Colusa County, California, 06011, 21396, 52168, 7931, 196000, 4331, 2666, 1665
Contra Costa County, California, 06013, 1096068, 80185, 405001, 439900, 248668, 187267, 61401
Del Norte County, California, 06015, 27788, 40847, 11305, 183700, 5704, 3223, 2481
El Dorado County, California, 06017, 182093, 69584, 88639, 363000, 49861, 35908, 13953
Fresno County, California, 06019, 956749, 45233, 321955, 194600, 156474, 112196, 44278
Glenn County, California, 06021, 28029, 39349, 10893, 204400, 5855, 3661, 2194
Humboldt County, California, 06023, 135034, 42197, 62156, 279300, 29128, 17459, 11669
Imperial County, California, 06025, 178206, 41079, 56709, 151600, 25777, 17420, 8357
Inyo County, California, 06027, 18373, 45955, 9502, 240100, 5110, 2444, 2666
Kern County, California, 06029, 865736, 49026, 289529, 167400, 147125, 104644, 42481
Kings County, California, 06031, 150998, 46481, 44628, 169500, 21363, 15240, 6123
Lake County, California, 06033, 64158, 35578, 35626, 164300, 17014, 9294, 7720
Lassen County, California, 06035, 32645, 51555, 12733, 172900, 6315, 3868, 2447
Los Angeles County, California, 06037, 10038388, 56196, 3476718, 441900, 1499879, 1116026, 383853
Madera County, California, 06039, 153187, 45073, 49704, 189700, 26275, 17509, 8766
Marin County, California, 06041, 258349, 93257, 111990, 815100, 64729, 46540, 18189
Mariposa County, California, 06043, 17789, 47681, 10312, 235900, 5224, 2922, 2302
Mendocino County, California, 06045, 87544, 42980, 40643, 308400, 19679, 10725, 8954
Merced County, California, 06047, 263885, 42462, 84063, 161200, 40124, 28350, 11774
Modoc County, California, 06049, 9184, 37860, 5238, 153100, 2767, 1379, 1388
Mono County, California, 06051, 14146, 56944, 13982, 313000, 2919, 1767, 1152
Monterey County, California, 06053, 428441, 58783, 139794, 369100, 61747, 42747, 19000
Napa County, California, 06055, 140295, 71379, 55180, 466800, 29678, 20566, 9112
Nevada County, California, 06057, 98570, 56521, 53017, 347000, 29683, 19364, 10319
Orange County, California, 06059, 3116069, 76509, 1064642, 553600, 582151, 429236, 152915
Placer County, California, 06061, 366280, 73948, 156401, 358500, 94966, 70092, 24874
Plumas County, California, 06063, 18966, 47333, 15674, 217200, 5942, 3754, 2188
Riverside County, California, 06065, 2298032, 56603, 815322, 253200, 453139, 330772, 122367
Sacramento County, California, 06067, 1465832, 55987, 560271, 248400, 289606, 216414, 73192
San Benito County, California, 06069, 57557, 71077, 18038, 380200, 10778, 8311, 2467
San Bernardino County, California, 06071, 2094769, 53433, 705962, 236700, 366514, 274454, 92060
San Diego County, California, 06073, 3223096, 64309, 1180806, 429600, 579079, 427721, 151358
San Francisco County, California, 06075, 840763, 81294, 383676, 799600, 128698, 89622, 39076
San Joaquin County, California, 06077, 708554, 53274, 236562, 223000, 124087, 90592, 33495
San Luis Obispo County, California, 06079, 276517, 60691, 118806, 445700, 59714, 40386, 19328
San Mateo County, California, 06081, 748731, 93623, 272838, 776300, 153422, 111522, 41900
Santa Barbara County, California, 06083, 435850, 63985, 154135, 465300, 74083, 50613, 23470
Santa Clara County, California, 06085, 1868149, 96310, 646190, 698600, 352836, 257770, 95066
Santa Cruz County, California, 06087, 269278, 67256, 105034, 578800, 54628, 38143, 16485
Shasta County, California, 06089, 178942, 44620, 77790, 216600, 43331, 27188, 16143
Sierra County, California, 06091, 3021, 42833, 2311, 170400, 981, 430, 551
Siskiyou County, California, 06093, 43895, 37170, 24002, 174700, 12199, 6294, 5905
Solano County, California, 06095, 425753, 66828, 154380, 279100, 86079, 65993, 20086
Sonoma County, California, 06097, 495078, 64240, 206399, 436400, 111590, 78790, 32800
Stanislaus County, California, 06099, 527367, 50125, 180169, 190800, 95954, 69569, 26385
Sutter County, California, 06101, 95247, 52017, 34065, 198700, 18864, 12991, 5873
Tehama County, California, 06103, 63152, 41001, 27220, 171500, 16008, 10140, 5868
Trinity County, California, 06105, 13373, 34974, 8770, 263100, 3778, 1852, 1926
Tulare County, California, 06107, 454033, 42031, 144792, 162700, 75685, 53843, 21842
Tuolumne County, California, 06109, 54079, 50306, 31361, 259300, 15129, 8685, 6444
Ventura County, California, 06111, 840833, 77348, 283899, 458100, 172609, 131564, 41045
Yolo County, California, 06113, 207320, 54989, 76090, 325700, 37504, 26856, 10648
Yuba County, California, 06115, 73437, 46892, 27930, 172100, 14593, 10358, 4235
Adams County, Colorado, 08001, 471206, 58946, 165046, 198800, 101043, 78253, 22790
Alamosa County, Colorado, 08003, 16269, 32395, 6673, 144300, 3386, 1967, 1419
Arapahoe County, Colorado, 08005, 608310, 63265, 241431, 247600, 142695, 110831, 31864
Archuleta County, Colorado, 08007, 12174, 46646, 8879, 264200, 3827, 2239, 1588
Baca County, Colorado, 08009, 3701, 38000, 2234, 73200, 1143, 466, 677
Bent County, Colorado, 08011, 5895, 36791, 2080, 65700, 1155, 439, 716
Boulder County, Colorado, 08013, 310032, 70961, 129739, 368800, 76163, 55067, 21096
Broomfield County, Colorado, 08014, 60699, 81898, 24710, 295500, 16098, 12781, 3317
Chaffee County, Colorado, 08015, 18309, 51092, 10260, 274200, 5859, 3339, 2520
Cheyenne County, Colorado, 08017, 2002, 52554, 899, 82300, 559, 241, 318
Clear Creek County, Colorado, 08019, 9136, 67710, 5684, 283900, 3328, 2394, 934
Conejos County, Colorado, 08021, 8249, 36652, 4301, 107100, 2340, 1162, 1178
Costilla County, Colorado, 08023, 3581, 31321, 2669, 102300, 1107, 384, 723
Crowley County, Colorado, 08025, 5551, 31151, 1546, 76100, 941, 468, 473
Custer County, Colorado, 08027, 4303, 35000, 4323, 220400, 1591, 932, 659
Delta County, Colorado, 08029, 30214, 42452, 14500, 193000, 8595, 4707, 3888
Denver County, Colorado, 08031, 649654, 53637, 294191, 271300, 136274, 103371, 32903
Dolores County, Colorado, 08033, 1862, 31875, 1335, 119100, 544, 186, 358
Douglas County, Colorado, 08035, 306974, 102964, 115068, 354700, 88261, 74509, 13752
Eagle County, Colorado, 08037, 52576, 72214, 31474, 419400, 11974, 9193, 2781
Elbert County, Colorado, 08039, 23855, 84963, 9034, 337400, 7466, 6138, 1328
El Paso County, Colorado, 08041, 655024, 58206, 261745, 218300, 153354, 115978, 37376
Fremont County, Colorado, 08043, 46809, 40423, 19240, 158500, 11584, 6463, 5121
Garfield County, Colorado, 08045, 57076, 56590, 23338, 287500, 13331, 9892, 3439
Gilpin County, Colorado, 08047, 5605, 65670, 3648, 252800, 1977, 1399, 578
Grand County, Colorado, 08049, 14411, 63628, 16209, 282000, 3818, 2765, 1053
Gunnison County, Colorado, 08051, 15651, 48071, 11542, 319200, 3729, 2434, 1295
Hinsdale County, Colorado, 08053, 874, 57083, 1433, 276000, 302, 150, 152
Huerfano County, Colorado, 08055, 6502, 31715, 5116, 147600, 2207, 1171, 1036
Jackson County, Colorado, 08057, 1335, 46014, 1262, 158000, 418, 160, 258
Jefferson County, Colorado, 08059, 552344, 70164, 232477, 279500, 155713, 116105, 39608
Kiowa County, Colorado, 08061, 1463, 40304, 820, 83600, 442, 191, 251
Kit Carson County, Colorado, 08063, 7980, 40603, 3503, 122300, 2045, 826, 1219
Lake County, Colorado, 08065, 7362, 45367, 4523, 168500, 1710, 892, 818
La Plata County, Colorado, 08067, 53182, 60278, 26365, 332700, 14413, 9370, 5043
Larimer County, Colorado, 08069, 318227, 59805, 136851, 263400, 80264, 57136, 23128
Las Animas County, Colorado, 08071, 14503, 45067, 8232, 150600, 4008, 2238, 1770
Lincoln County, Colorado, 08073, 5478, 39005, 2155, 118300, 1103, 581, 522
Logan County, Colorado, 08075, 21928, 42319, 8949, 124700, 5271, 2903, 2368
Mesa County, Colorado, 08077, 147834, 49322, 63472, 199000, 40908, 27725, 13183
Mineral County, Colorado, 08079, 733, 48125, 1249, 277100, 325, 151, 174
Moffat County, Colorado, 08081, 13117, 51387, 6172, 175800, 3486, 2223, 1263
Montezuma County, Colorado, 08083, 25700, 43553, 12002, 180400, 7331, 3562, 3769
Montrose County, Colorado, 08085, 40815, 43999, 18302, 190900, 11746, 6956, 4790
Morgan County, Colorado, 08087, 28359, 48450, 11452, 145500, 6747, 3753, 2994
Otero County, Colorado, 08089, 18572, 32311, 8920, 91900, 4753, 2566, 2187
Ouray County, Colorado, 08091, 4580, 61624, 3084, 388600, 1419, 824, 595
Park County, Colorado, 08093, 16189, 56969, 14134, 244800, 6027, 4297, 1730
Phillips County, Colorado, 08095, 4371, 43639, 1939, 132500, 1202, 630, 572
Pitkin County, Colorado, 08097, 17420, 71196, 13027, 620700, 4934, 3183, 1751
Prowers County, Colorado, 08099, 12235, 40179, 5899, 87400, 3264, 1749, 1515
Pueblo County, Colorado, 08101, 161519, 41286, 69959, 138600, 40369, 26312, 14057
Rio Blanco County, Colorado, 08103, 6712, 61842, 3342, 204800, 1656, 876, 780
Rio Grande County, Colorado, 08105, 11745, 39672, 6618, 133700, 3078, 1770, 1308
Routt County, Colorado, 08107, 23606, 64963, 16378, 394600, 6519, 4402, 2117
Saguache County, Colorado, 08109, 6238, 33393, 3904, 146700, 1813, 799, 1014
San Juan County, Colorado, 08111, 606, 36324, 698, 223200, 182, 99, 83
San Miguel County, Colorado, 08113, 7676, 56047, 6687, 512800, 2001, 1304, 697
Sedgwick County, Colorado, 08115, 2365, 44191, 1287, 86800, 705, 306, 399
Summit County, Colorado, 08117, 28940, 67983, 30238, 478800, 6728, 5168, 1560
Teller County, Colorado, 08119, 23340, 62372, 12730, 239000, 7728, 5590, 2138
Washington County, Colorado, 08121, 4795, 45541, 2422, 113200, 1450, 642, 808
Weld County, Colorado, 08123, 270948, 60572, 99226, 210100, 65424, 49449, 15975
Yuma County, Colorado, 08125, 10185, 43105, 4438, 136400, 2433, 1191, 1242
Fairfield County, Connecticut, 09001, 939983, 84233, 363556, 416000, 228381, 163508, 64873
Hartford County, Connecticut, 09003, 896943, 66395, 374453, 236400, 224000, 156517, 67483
Litchfield County, Connecticut, 09005, 186304, 72061, 87447, 254600, 57397, 39969, 17428
Middlesex County, Connecticut, 09007, 165165, 79893, 75162, 285100, 49652, 34463, 15189
New Haven County, Connecticut, 09009, 862224, 61640, 362351, 245200, 204886, 142134, 62752
New London County, Connecticut, 09011, 273185, 66233, 121258, 244000, 70847, 48296, 22551
Tolland County, Connecticut, 09013, 151948, 79626, 58383, 247700, 39880, 27906, 11974
Windham County, Connecticut, 09015, 117470, 59392, 49176, 197500, 31184, 22369, 8815
Kent County, Delaware, 10001, 169509, 54976, 67315, 200500, 42185, 28319, 13866
New Castle County, Delaware, 10003, 549643, 65476, 219421, 242400, 139675, 101849, 37826
Sussex County, Delaware, 10005, 207302, 53751, 127680, 228500, 62989, 37363, 25626
District of Columbia, District of Columbia, 11001, 647484, 70848, 303312, 475800, 112750, 87023, 25727
Alachua County, Florida, 12001, 254218, 43073, 113659, 164000, 51448, 30886, 20562
Baker County, Florida, 12003, 27135, 47121, 9634, 114300, 6406, 3960, 2446
Bay County, Florida, 12005, 175353, 47368, 100109, 157800, 41737, 24785, 16952
Bradford County, Florida, 12007, 27223, 41606, 10926, 89200, 6477, 3172, 3305
Brevard County, Florida, 12009, 553591, 48925, 271654, 142200, 159654, 95589, 64065
Broward County, Florida, 12011, 1843152, 51968, 814454, 185900, 425691, 280487, 145204
Calhoun County, Florida, 12013, 14615, 34510, 5944, 75500, 3875, 1569, 2306
Charlotte County, Florida, 12015, 165783, 44244, 101195, 145700, 56019, 27018, 29001
Citrus County, Florida, 12017, 139654, 38312, 77819, 112300, 49534, 23696, 25838
Clay County, Florida, 12019, 197417, 58290, 76888, 153000, 51624, 36394, 15230
Collier County, Florida, 12021, 341091, 57452, 201582, 272800, 93733, 47370, 46363
Columbia County, Florida, 12023, 67806, 41926, 28392, 103500, 16917, 8958, 7959
DeSoto County, Florida, 12027, 34957, 35165, 14681, 80400, 7907, 3438, 4469
Dixie County, Florida, 12029, 16091, 36292, 9192, 73800, 4769, 1963, 2806
Duval County, Florida, 12031, 890673, 47690, 393571, 142300, 200029, 139044, 60985
Escambia County, Florida, 12033, 306327, 45390, 138178, 120200, 69678, 41428, 28250
Flagler County, Florida, 12035, 100783, 47866, 49273, 164100, 28625, 15897, 12728
Franklin County, Florida, 12037, 11628, 40401, 8582, 122600, 3147, 1465, 1682
Gadsden County, Florida, 12039, 46424, 35567, 19452, 108400, 11990, 6112, 5878
Gilchrist County, Florida, 12041, 16992, 40623, 7253, 99900, 5006, 2443, 2563
Glades County, Florida, 12043, 13272, 34877, 6865, 84500, 2908, 960, 1948
Gulf County, Florida, 12045, 15785, 41788, 9157, 142700, 3923, 1862, 2061
Hamilton County, Florida, 12047, 14395, 35048, 5733, 69500, 3423, 1376, 2047
Hardee County, Florida, 12049, 27468, 35457, 9642, 80700, 5300, 2079, 3221
Hendry County, Florida, 12051, 38363, 36771, 14408, 72400, 7802, 3646, 4156
Hernando County, Florida, 12053, 174809, 40945, 84630, 109300, 54813, 29551, 25262
Highlands County, Florida, 12055, 98328, 35093, 55066, 85200, 30667, 12228, 18439
Hillsborough County, Florida, 12057, 1302884, 50579, 549024, 159200, 284285, 191825, 92460
Holmes County, Florida, 12059, 19635, 35020, 8598, 85100, 5421, 2457, 2964
Indian River County, Florida, 12061, 142866, 45798, 77059, 157800, 43168, 21462, 21706
Jackson County, Florida, 12063, 48900, 35098, 20880, 92100, 11747, 5589, 6158
Jefferson County, Florida, 12065, 14198, 43355, 6602, 135200, 4150, 2216, 1934
Lafayette County, Florida, 12067, 8801, 35864, 3239, 109800, 2001, 873, 1128
Lake County, Florida, 12069, 310561, 46403, 146181, 140100, 89192, 47557, 41635
Lee County, Florida, 12071, 663675, 48537, 374333, 157400, 174162, 92498, 81664
Leon County, Florida, 12073, 282940, 46745, 125915, 180900, 58008, 39869, 18139
Levy County, Florida, 12075, 39821, 35782, 19917, 88600, 11899, 5363, 6536
Liberty County, Florida, 12077, 8295, 39406, 3409, 74000, 1801, 813, 988
Madison County, Florida, 12079, 18729, 32164, 8448, 78500, 5186, 2116, 3070
Manatee County, Florida, 12081, 343729, 49675, 177046, 169000, 94029, 49035, 44994
Marion County, Florida, 12083, 336811, 39459, 163687, 111000, 99961, 51661, 48300
Martin County, Florida, 12085, 151586, 51593, 78706, 200200, 46795, 23991, 22804
Miami-Dade County, Florida, 12086, 2639042, 43129, 998833, 203300, 452826, 294099, 158727
Monroe County, Florida, 12087, 75901, 57290, 52913, 386400, 17675, 8993, 8682
Nassau County, Florida, 12089, 75880, 54116, 35681, 177100, 21575, 12955, 8620
Okaloosa County, Florida, 12091, 192237, 55880, 94238, 186300, 47561, 30327, 17234
Okeechobee County, Florida, 12093, 39255, 35405, 18278, 93800, 9229, 4189, 5040
Orange County, Florida, 12095, 1229039, 47943, 501513, 163800, 238900, 172085, 66815
Osceola County, Florida, 12097, 300870, 44254, 132185, 132100, 56192, 39110, 17082
Palm Beach County, Florida, 12099, 1378806, 53363, 671317, 204700, 369521, 209277, 160244
Pasco County, Florida, 12101, 479288, 45064, 231612, 117800, 137465, 75430, 62035
Pinellas County, Florida, 12103, 931477, 45819, 503658, 150200, 260848, 145955, 114893
Polk County, Florida, 12105, 626676, 43162, 282248, 107300, 152336, 82772, 69564
Putnam County, Florida, 12107, 72696, 31715, 36824, 85500, 20381, 9426, 10955
St. Johns County, Florida, 12109, 210495, 66194, 94826, 244400, 59811, 41043, 18768
St. Lucie County, Florida, 12111, 288006, 43459, 137203, 125600, 78580, 44751, 33829
Santa Rosa County, Florida, 12113, 161021, 58923, 66786, 161400, 42598, 29023, 13575
Sarasota County, Florida, 12115, 392038, 51766, 230150, 181400, 127964, 63632, 64332
Seminole County, Florida, 12117, 437346, 57010, 184374, 176100, 102912, 77605, 25307
Sumter County, Florida, 12119, 108501, 50350, 61171, 213900, 43312, 18196, 25116
Suwannee County, Florida, 12121, 43595, 36289, 18927, 92600, 10752, 4934, 5818
Taylor County, Florida, 12123, 22685, 36181, 10906, 83700, 5862, 2556, 3306
Union County, Florida, 12125, 15191, 39163, 4477, 87500, 2547, 1397, 1150
Volusia County, Florida, 12127, 503719, 41117, 255437, 131600, 140203, 78452, 61751
Wakulla County, Florida, 12129, 31128, 50340, 12841, 122200, 7998, 4932, 3066
Walton County, Florida, 12131, 59487, 44966, 46918, 169800, 16858, 9137, 7721
Washington County, Florida, 12133, 24629, 38970, 10700, 82900, 6447, 2892, 3555
Appling County, Georgia, 13001, 18417, 37135, 8434, 72300, 4752, 2015, 2737
Atkinson County, Georgia, 13003, 8294, 30933, 3476, 74400, 1985, 776, 1209
Bacon County, Georgia, 13005, 11222, 37162, 4758, 62800, 2723, 1006, 1717
Baker County, Georgia, 13007, 3292, 44297, 1660, 78500, 970, 451, 519
Baldwin County, Georgia, 13009, 45795, 32460, 20205, 101700, 8687, 4174, 4513
Banks County, Georgia, 13011, 18336, 41472, 7565, 121600, 5066, 2925, 2141
Barrow County, Georgia, 13013, 72012, 52012, 26700, 119700, 17239, 13046, 4193
Bartow County, Georgia, 13015, 101336, 48893, 39838, 123800, 23238, 15964, 7274
Ben Hill County, Georgia, 13017, 17477, 29994, 7914, 80900, 4101, 2159, 1942
Berrien County, Georgia, 13019, 19019, 31835, 8650, 84300, 5074, 2525, 2549
Bibb County, Georgia, 13021, 154816, 36519, 70071, 118700, 30268, 19553, 10715
Bleckley County, Georgia, 13023, 12746, 38991, 5275, 87100, 3054, 1516, 1538
Brantley County, Georgia, 13025, 18452, 37206, 7963, 67400, 5258, 2243, 3015
Brooks County, Georgia, 13027, 15637, 32663, 7660, 94900, 4550, 2585, 1965
Bryan County, Georgia, 13029, 33151, 63327, 12676, 195600, 7819, 5603, 2216
Bulloch County, Georgia, 13031, 72386, 36032, 29593, 129700, 12967, 7874, 5093
Burke County, Georgia, 13033, 23007, 33641, 9832, 81000, 5724, 2847, 2877
Butts County, Georgia, 13035, 23445, 41667, 9291, 113900, 5577, 3545, 2032
Calhoun County, Georgia, 13037, 6489, 25513, 2339, 56600, 1203, 530, 673
Camden County, Georgia, 13039, 51445, 52473, 21366, 151100, 11388, 7737, 3651
Candler County, Georgia, 13043, 11031, 30185, 4714, 89000, 2370, 1289, 1081
Carroll County, Georgia, 13045, 112595, 43586, 44657, 112100, 25147, 16742, 8405
Catoosa County, Georgia, 13047, 65375, 50876, 26735, 129800, 17962, 11612, 6350
Charlton County, Georgia, 13049, 13130, 42778, 4436, 82000, 2776, 1291, 1485
Chatham County, Georgia, 13051, 279290, 47218, 121877, 171500, 57315, 37934, 19381
Chattahoochee County, Georgia, 13053, 11914, 43378, 3352, 64800, 713, 291, 422
Chattooga County, Georgia, 13055, 25241, 32913, 10903, 63900, 6209, 2497, 3712
Cherokee County, Georgia, 13057, 225944, 68926, 84607, 190500, 61211, 47897, 13314
Clarke County, Georgia, 13059, 120905, 32162, 51529, 150300, 17549, 11436, 6113
Clay County, Georgia, 13061, 3104, 20438, 1883, 69400, 700, 207, 493
Clayton County, Georgia, 13063, 267234, 40938, 104656, 85200, 46802, 35023, 11779
Clinch County, Georgia, 13065, 6791, 24015, 2974, 58000, 1781, 691, 1090
Cobb County, Georgia, 13067, 719133, 65873, 290963, 197400, 172334, 133735, 38599
Coffee County, Georgia, 13069, 43003, 33965, 16974, 83400, 9553, 4724, 4829
Colquitt County, Georgia, 13071, 46024, 32409, 18316, 79600, 10196, 4983, 5213
Columbia County, Georgia, 13073, 136204, 71021, 52267, 170800, 35613, 26750, 8863
Cook County, Georgia, 13075, 17033, 35683, 7247, 86000, 4190, 2269, 1921
Coweta County, Georgia, 13077, 133416, 62461, 51447, 181000, 35494, 26672, 8822
Crawford County, Georgia, 13079, 12539, 41825, 5257, 85800, 3609, 1951, 1658
Crisp County, Georgia, 13081, 23314, 31615, 10720, 98200, 5108, 2487, 2621
Dade County, Georgia, 13083, 16445, 46434, 7269, 118300, 4789, 2394, 2395
Dawson County, Georgia, 13085, 22673, 56943, 10541, 188300, 6191, 3941, 2250
Decatur County, Georgia, 13087, 27378, 31284, 12137, 114400, 6303, 3417, 2886
DeKalb County, Georgia, 13089, 716331, 51376, 306218, 163000, 147739, 113757, 33982
Dodge County, Georgia, 13091, 21180, 34271, 9767, 67900, 5288, 2531, 2757
Dooly County, Georgia, 13093, 14293, 28696, 6239, 73000, 3216, 1292, 1924
Dougherty County, Georgia, 13095, 93310, 32084, 40706, 101400, 16202, 9625, 6577
Douglas County, Georgia, 13097, 136520, 53881, 51775, 121300, 31687, 22880, 8807
Early County, Georgia, 13099, 10579, 31680, 4930, 81600, 2640, 1224, 1416
Echols County, Georgia, 13101, 4048, 32959, 1665, 67600, 932, 344, 588
Effingham County, Georgia, 13103, 54630, 63100, 20361, 152600, 14107, 10246, 3861
Elbert County, Georgia, 13105, 19537, 35388, 9521, 82400, 5278, 2417, 2861
Emanuel County, Georgia, 13107, 22731, 32229, 9904, 67800, 5443, 2473, 2970
Evans County, Georgia, 13109, 10814, 37865, 4637, 87900, 2532, 1537, 995
Fannin County, Georgia, 13111, 23742, 37049, 16482, 164600, 7418, 3648, 3770
Fayette County, Georgia, 13113, 108655, 79066, 41132, 229500, 31316, 22568, 8748
Floyd County, Georgia, 13115, 96169, 41549, 40458, 117100, 21182, 12472, 8710
Forsyth County, Georgia, 13117, 196236, 88816, 69019, 267300, 52420, 42029, 10391
Franklin County, Georgia, 13119, 22110, 33816, 10480, 102700, 5867, 2829, 3038
Fulton County, Georgia, 13121, 983903, 57207, 444761, 241300, 196617, 149022, 47595
Gilmer County, Georgia, 13123, 28673, 40228, 16629, 139600, 8388, 4743, 3645
Glascock County, Georgia, 13125, 3087, 40759, 1506, 66300, 829, 331, 498
Glynn County, Georgia, 13127, 81743, 45918, 41471, 159200, 19709, 11844, 7865
Gordon County, Georgia, 13129, 55889, 41612, 22220, 113000, 12786, 7426, 5360
Grady County, Georgia, 13131, 25243, 34187, 10717, 115100, 5360, 2560, 2800
Greene County, Georgia, 13133, 16331, 42408, 8938, 169300, 4820, 2474, 2346
Gwinnett County, Georgia, 13135, 859234, 60289, 296368, 167700, 181829, 144297, 37532
Habersham County, Georgia, 13137, 43527, 40907, 18124, 131500, 11128, 6209, 4919
Hall County, Georgia, 13139, 187916, 51202, 69302, 159700, 41434, 27376, 14058
Hancock County, Georgia, 13141, 8881, 24925, 5289, 66700, 2203, 806, 1397
Haralson County, Georgia, 13143, 28565, 41910, 12254, 103500, 7559, 4302, 3257
Harris County, Georgia, 13145, 32776, 63824, 13604, 201100, 9689, 6542, 3147
Hart County, Georgia, 13147, 25498, 37653, 12963, 116600, 7300, 3385, 3915
Heard County, Georgia, 13149, 11617, 41525, 5114, 88200, 3153, 1834, 1319
Henry County, Georgia, 13151, 211512, 60424, 77281, 140300, 51234, 41000, 10234
Houston County, Georgia, 13153, 147570, 53270, 59989, 132400, 35105, 24414, 10691
Irwin County, Georgia, 13155, 9408, 34156, 4024, 80000, 2450, 1020, 1430
Jackson County, Georgia, 13157, 61420, 53379, 23756, 155700, 16202, 11090, 5112
Jasper County, Georgia, 13159, 13593, 42368, 6215, 111200, 3766, 2254, 1512
Jeff Davis County, Georgia, 13161, 14990, 36385, 6421, 71800, 4094, 1984, 2110
Jefferson County, Georgia, 13163, 16374, 26557, 7258, 64800, 3923, 1531, 2392
Jenkins County, Georgia, 13165, 8922, 24604, 4727, 54700, 2303, 759, 1544
Johnson County, Georgia, 13167, 9794, 34438, 4088, 67600, 2343, 933, 1410
Jones County, Georgia, 13169, 28738, 51857, 11600, 129300, 8348, 5128, 3220
Lamar County, Georgia, 13171, 18114, 40344, 7521, 124300, 4498, 2591, 1907
Lanier County, Georgia, 13173, 10403, 37605, 4298, 100900, 2364, 1457, 907
Laurens County, Georgia, 13175, 47886, 32356, 21323, 84100, 11227, 4204, 7023
Lee County, Georgia, 13177, 28946, 61537, 10589, 157100, 7171, 5209, 1962
Liberty County, Georgia, 13179, 64427, 42201, 27088, 122400, 10887, 7438, 3449
Lincoln County, Georgia, 13181, 7720, 34243, 4788, 113800, 2582, 1140, 1442
Long County, Georgia, 13183, 16588, 48863, 6155, 103300, 3211, 2102, 1109
Lowndes County, Georgia, 13185, 113203, 36834, 45399, 135000, 20190, 13046, 7144
Lumpkin County, Georgia, 13187, 30921, 43804, 13008, 167400, 7198, 4561, 2637
McDuffie County, Georgia, 13189, 21582, 36656, 9271, 102300, 5156, 2964, 2192
McIntosh County, Georgia, 13191, 14007, 42988, 9304, 108400, 4112, 2229, 1883
Macon County, Georgia, 13193, 14045, 28684, 6072, 68100, 2874, 1268, 1606
Madison County, Georgia, 13195, 28232, 41912, 11752, 122700, 7364, 3855, 3509
Marion County, Georgia, 13197, 8739, 36242, 4118, 93300, 2205, 1100, 1105
Meriwether County, Georgia, 13199, 21297, 35832, 9925, 89800, 5289, 2777, 2512
Miller County, Georgia, 13201, 5936, 33983, 2766, 92500, 1562, 667, 895
Mitchell County, Georgia, 13205, 22982, 31915, 8951, 76700, 5372, 2572, 2800
Monroe County, Georgia, 13207, 26915, 48744, 10900, 153300, 7257, 4337, 2920
Montgomery County, Georgia, 13209, 8968, 34672, 3892, 75200, 2212, 960, 1252
Morgan County, Georgia, 13211, 17900, 51820, 7499, 182900, 4985, 3158, 1827
Murray County, Georgia, 13213, 39401, 35539, 15818, 89800, 9624, 4926, 4698
Muscogee County, Georgia, 13215, 200285, 42306, 83503, 134500, 36266, 24966, 11300
Newton County, Georgia, 13217, 102645, 49179, 38364, 115500, 24301, 18495, 5806
Oconee County, Georgia, 13219, 34400, 72182, 12847, 235700, 9453, 6835, 2618
Oglethorpe County, Georgia, 13221, 14688, 44226, 6487, 121200, 4168, 2320, 1848
Paulding County, Georgia, 13223, 147400, 60109, 52914, 133500, 38811, 31212, 7599
Peach County, Georgia, 13225, 27086, 41588, 11223, 124600, 6512, 4049, 2463
Pickens County, Georgia, 13227, 29740, 54123, 13680, 175000, 8687, 5571, 3116
Pierce County, Georgia, 13229, 18934, 40247, 7964, 98000, 5149, 2964, 2185
Pike County, Georgia, 13231, 17812, 51338, 6821, 155200, 5035, 3236, 1799
Polk County, Georgia, 13233, 41215, 37853, 16930, 102600, 9881, 5530, 4351
Pulaski County, Georgia, 13235, 11590, 38750, 4844, 100700, 2396, 1152, 1244
Putnam County, Georgia, 13237, 21247, 44299, 12748, 155100, 6205, 3941, 2264
Quitman County, Georgia, 13239, 2326, 31487, 2090, 69200, 757, 325, 432
Rabun County, Georgia, 13241, 16266, 35211, 12441, 161500, 4989, 2359, 2630
Randolph County, Georgia, 13243, 7315, 28377, 3667, 68400, 1703, 743, 960
Richmond County, Georgia, 13245, 201291, 37424, 86939, 101900, 38074, 24388, 13686
Rockdale County, Georgia, 13247, 86901, 50455, 33319, 140000, 20405, 14853, 5552
Schley County, Georgia, 13249, 5074, 39375, 2176, 91500, 1212, 606, 606
Screven County, Georgia, 13251, 14206, 34466, 6675, 80500, 3716, 1760, 1956
Seminole County, Georgia, 13253, 8769, 34905, 4801, 75600, 2470, 1054, 1416
Spalding County, Georgia, 13255, 63873, 40246, 26926, 111500, 13943, 9009, 4934
Stephens County, Georgia, 13257, 25620, 40315, 12541, 101100, 6618, 3232, 3386
Stewart County, Georgia, 13259, 5868, 21118, 2342, 52500, 1077, 294, 783
Sumter County, Georgia, 13261, 31429, 32758, 13857, 84700, 6651, 3555, 3096
Talbot County, Georgia, 13263, 6490, 34078, 3376, 72300, 2142, 911, 1231
Taliaferro County, Georgia, 13265, 1721, 26306, 1073, 63100, 521, 146, 375
Tattnall County, Georgia, 13267, 25302, 33980, 9888, 80600, 5451, 2738, 2713
Taylor County, Georgia, 13269, 8401, 28143, 4513, 58000, 2392, 991, 1401
Telfair County, Georgia, 13271, 16416, 26449, 7228, 56400, 3154, 1035, 2119
Terrell County, Georgia, 13273, 9213, 28688, 4167, 83700, 1942, 936, 1006
Thomas County, Georgia, 13275, 44824, 36641, 20306, 123100, 10420, 5617, 4803
Tift County, Georgia, 13277, 40787, 37653, 16414, 112400, 8202, 4683, 3519
Toombs County, Georgia, 13279, 27210, 33679, 12101, 89900, 6619, 3320, 3299
Towns County, Georgia, 13281, 10800, 37000, 7854, 175100, 3411, 1624, 1787
Treutlen County, Georgia, 13283, 6762, 38596, 3231, 71100, 1830, 632, 1198
Troup County, Georgia, 13285, 68867, 41489, 28241, 116300, 14265, 9167, 5098
Turner County, Georgia, 13287, 8338, 31806, 3827, 70900, 2117, 922, 1195
Twiggs County, Georgia, 13289, 8509, 30468, 4197, 56900, 2339, 693, 1646
Union County, Georgia, 13291, 21725, 40799, 14203, 184900, 6589, 2666, 3923
Upson County, Georgia, 13293, 26528, 35774, 12124, 85600, 6470, 3604, 2866
Walker County, Georgia, 13295, 68285, 41632, 30090, 105900, 18601, 9550, 9051
Walton County, Georgia, 13297, 86201, 54453, 32502, 152900, 21705, 15383, 6322
Ware County, Georgia, 13299, 35723, 34909, 16394, 78600, 8936, 4213, 4723
Warren County, Georgia, 13301, 5561, 29176, 2955, 62300, 1462, 616, 846
Washington County, Georgia, 13303, 20785, 37932, 9040, 80400, 5049, 2179, 2870
Wayne County, Georgia, 13305, 30046, 38955, 12125, 91400, 6884, 3726, 3158
Webster County, Georgia, 13307, 2720, 37063, 1392, 46000, 893, 323, 570
Wheeler County, Georgia, 13309, 7956, 27620, 2590, 49400, 1269, 347, 922
White County, Georgia, 13311, 27791, 40888, 16001, 155800, 8353, 4660, 3693
Whitfield County, Georgia, 13313, 103456, 40596, 39731, 120400, 22242, 13576, 8666
Wilcox County, Georgia, 13315, 8972, 32043, 3500, 64900, 1972, 871, 1101
Wilkes County, Georgia, 13317, 9991, 32727, 5160, 95200, 2835, 1090, 1745
Wilkinson County, Georgia, 13319, 9386, 38485, 4444, 71500, 2572, 869, 1703
Worth County, Georgia, 13321, 21156, 37974, 9222, 70800, 5844, 2663, 3181
Hawaii County, Hawaii, 15001, 191482, 52108, 84656, 301700, 43213, 26147, 17066
Honolulu County, Hawaii, 15003, 984178, 74460, 341239, 580200, 168551, 116463, 52088
Kalawao County, Hawaii, 15005, 85, 66250, 98, 0, 2, 0, 2
Kauai County, Hawaii, 15007, 69691, 65101, 30238, 480600, 13799, 8573, 5226
Maui County, Hawaii, 15009, 160863, 66476, 71157, 509700, 30824, 21065, 9759
Ada County, Idaho, 16001, 417501, 56356, 164992, 188800, 105839, 79011, 26828
Adams County, Idaho, 16003, 3880, 39565, 2645, 145000, 1227, 588, 639
Bannock County, Idaho, 16005, 83604, 43779, 33337, 145300, 20313, 13426, 6887
Bear Lake County, Idaho, 16007, 5939, 48654, 3965, 138900, 1867, 999, 868
Benewah County, Idaho, 16009, 9088, 39863, 4631, 142800, 2647, 1249, 1398
Bingham County, Idaho, 16011, 45407, 50155, 16202, 141400, 10890, 6288, 4602
Blaine County, Idaho, 16013, 21309, 60088, 15109, 374800, 5884, 3811, 2073
Boise County, Idaho, 16015, 6885, 44238, 5336, 188200, 2451, 1481, 970
Bonner County, Idaho, 16017, 41066, 42171, 24589, 211300, 12499, 7621, 4878
Bonneville County, Idaho, 16019, 107788, 50762, 40471, 155600, 26254, 17712, 8542
Boundary County, Idaho, 16021, 10961, 38961, 5231, 172800, 3158, 1720, 1438
Butte County, Idaho, 16023, 2653, 37891, 1278, 105800, 805, 432, 373
Camas County, Idaho, 16025, 1052, 42614, 876, 164500, 296, 207, 89
Canyon County, Idaho, 16027, 198921, 42888, 70720, 122200, 45221, 32200, 13021
Caribou County, Idaho, 16029, 6808, 58021, 3218, 126600, 2118, 1131, 987
Cassia County, Idaho, 16031, 23369, 45695, 8425, 131500, 5466, 3361, 2105
Clark County, Idaho, 16033, 901, 33672, 539, 97300, 171, 112, 59
Clearwater County, Idaho, 16035, 8560, 38837, 4466, 126200, 2865, 1323, 1542
Custer County, Idaho, 16037, 4234, 39457, 3133, 161500, 1388, 657, 731
Elmore County, Idaho, 16039, 26175, 43848, 12195, 135300, 5758, 3672, 2086
Franklin County, Idaho, 16041, 12914, 48133, 4631, 160900, 3350, 1985, 1365
Fremont County, Idaho, 16043, 12945, 47988, 8626, 152100, 3685, 2068, 1617
Gem County, Idaho, 16045, 16731, 40828, 7103, 140200, 4432, 2913, 1519
Gooding County, Idaho, 16047, 15233, 39930, 6059, 127700, 3589, 1979, 1610
Idaho County, Idaho, 16049, 16312, 38191, 8680, 153700, 5282, 2621, 2661
Jefferson County, Idaho, 16051, 26792, 51171, 8829, 156000, 6656, 4177, 2479
Jerome County, Idaho, 16053, 22653, 41630, 8196, 135800, 4864, 3130, 1734
Kootenai County, Idaho, 16055, 145046, 49403, 65272, 185700, 39582, 27241, 12341
Latah County, Idaho, 16057, 38339, 42439, 16255, 191100, 8149, 5118, 3031
Lemhi County, Idaho, 16059, 7790, 34329, 4740, 172700, 2645, 1351, 1294
Lewis County, Idaho, 16061, 3812, 36505, 1879, 115300, 1177, 597, 580
Lincoln County, Idaho, 16063, 5260, 43273, 1961, 121000, 1154, 691, 463
Madison County, Idaho, 16065, 37916, 32233, 12386, 177700, 4908, 2948, 1960
Minidoka County, Idaho, 16067, 20279, 44853, 7745, 111000, 5299, 2884, 2415
Nez Perce County, Idaho, 16069, 39779, 48160, 17443, 167900, 11262, 7118, 4144
Oneida County, Idaho, 16071, 4245, 41338, 1929, 132500, 1259, 767, 492
Owyhee County, Idaho, 16073, 11364, 33440, 4771, 122400, 2636, 1362, 1274
Payette County, Idaho, 16075, 22700, 44257, 9024, 129300, 6194, 4028, 2166
Power County, Idaho, 16077, 7731, 44779, 2944, 125500, 1825, 1106, 719
Shoshone County, Idaho, 16079, 12571, 37665, 6991, 119600, 3900, 2205, 1695
Teton County, Idaho, 16081, 10285, 53474, 5498, 222900, 2588, 1653, 935
Twin Falls County, Idaho, 16083, 80004, 44048, 31577, 147900, 19207, 12249, 6958
Valley County, Idaho, 16085, 9720, 48384, 11868, 221500, 2314, 1403, 911
Washington County, Idaho, 16087, 10025, 34775, 4537, 127400, 2791, 1569, 1222
Adams County, Illinois, 17001, 67081, 45965, 29976, 110000, 19005, 10588, 8417
Alexander County, Illinois, 17003, 7364, 27265, 3969, 50200, 1777, 604, 1173
Bond County, Illinois, 17005, 17313, 47946, 7081, 106900, 4724, 2549, 2175
Boone County, Illinois, 17007, 53851, 58248, 19968, 143700, 14711, 10571, 4140
Brown County, Illinois, 17009, 6859, 50739, 2454, 85800, 1587, 902, 685
Bureau County, Illinois, 17011, 34115, 50423, 15647, 105600, 10561, 5864, 4697
Calhoun County, Illinois, 17013, 4999, 53869, 2828, 121400, 1638, 801, 837
Carroll County, Illinois, 17015, 14926, 48631, 8435, 95700, 5081, 2549, 2532
Cass County, Illinois, 17017, 13254, 47434, 5799, 77000, 3785, 2025, 1760
Champaign County, Illinois, 17019, 205766, 46495, 88981, 150200, 43897, 28264, 15633
Christian County, Illinois, 17021, 34200, 45334, 15539, 83800, 10447, 5786, 4661
Clark County, Illinois, 17023, 16159, 50517, 7744, 86200, 4955, 2636, 2319
Clay County, Illinois, 17025, 13582, 44209, 6380, 77000, 4394, 2150, 2244
Clinton County, Illinois, 17027, 37929, 63236, 15504, 134500, 11517, 6602, 4915
Coles County, Illinois, 17029, 53037, 39588, 23464, 91800, 13070, 7505, 5565
Cook County, Illinois, 17031, 5236393, 55251, 2176549, 218700, 1107485, 756665, 350820
Crawford County, Illinois, 17033, 19541, 47468, 8643, 81000, 6072, 3247, 2825
Cumberland County, Illinois, 17035, 10943, 46061, 4858, 93400, 3477, 1780, 1697
DeKalb County, Illinois, 17037, 104345, 54101, 41009, 165200, 21802, 14604, 7198
De Witt County, Illinois, 17039, 16388, 53959, 7522, 105300, 5359, 3098, 2261
Douglas County, Illinois, 17041, 19826, 51810, 8392, 100500, 5721, 3146, 2575
DuPage County, Illinois, 17043, 930412, 79658, 357016, 278500, 248508, 177055, 71453
Edgar County, Illinois, 17045, 17992, 45691, 8753, 76700, 5720, 2982, 2738
Edwards County, Illinois, 17047, 6649, 44497, 3170, 69300, 2350, 1023, 1327
Effingham County, Illinois, 17049, 34332, 52224, 14727, 128200, 10544, 5566, 4978
Fayette County, Illinois, 17051, 22136, 43944, 9234, 82400, 6309, 2977, 3332
Ford County, Illinois, 17053, 13835, 49947, 6302, 93100, 4210, 2177, 2033
Franklin County, Illinois, 17055, 39694, 39512, 18586, 66300, 12017, 5691, 6326
Fulton County, Illinois, 17057, 36323, 46083, 16167, 81500, 10818, 5610, 5208
Gallatin County, Illinois, 17059, 5385, 39636, 2736, 65700, 1857, 680, 1177
Greene County, Illinois, 17061, 13502, 42565, 6362, 76000, 4158, 2103, 2055
Grundy County, Illinois, 17063, 50277, 65887, 20249, 182400, 13864, 9510, 4354
Hamilton County, Illinois, 17065, 8322, 44159, 4068, 84700, 2709, 1231, 1478
Hancock County, Illinois, 17067, 18738, 47699, 9227, 83400, 6231, 3057, 3174
Hardin County, Illinois, 17069, 4228, 38838, 2290, 68800, 1390, 515, 875
Henderson County, Illinois, 17071, 7042, 47672, 3811, 87100, 2435, 1242, 1193
Henry County, Illinois, 17073, 49883, 53480, 22112, 110800, 15844, 9096, 6748
Iroquois County, Illinois, 17075, 29053, 47834, 13409, 95900, 9014, 4623, 4391
Jackson County, Illinois, 17077, 59534, 33871, 28641, 103000, 12236, 6317, 5919
Jasper County, Illinois, 17079, 9635, 54209, 4326, 94500, 3180, 1534, 1646
Jefferson County, Illinois, 17081, 38578, 43247, 16873, 87300, 11148, 5848, 5300
Jersey County, Illinois, 17083, 22625, 53271, 9979, 124300, 7175, 4235, 2940
Jo Daviess County, Illinois, 17085, 22397, 53221, 13578, 138900, 7532, 4164, 3368
Johnson County, Illinois, 17087, 12829, 42287, 5573, 93100, 3636, 1631, 2005
Kane County, Illinois, 17089, 524886, 70696, 183384, 213200, 126903, 94394, 32509
Kankakee County, Illinois, 17091, 112221, 52110, 45184, 138700, 28306, 18109, 10197
Kendall County, Illinois, 17093, 120036, 84385, 40930, 200200, 31778, 26006, 5772
Knox County, Illinois, 17095, 52112, 39976, 23945, 80400, 14218, 7160, 7058
Lake County, Illinois, 17097, 702898, 78026, 261229, 245300, 179785, 131085, 48700
LaSalle County, Illinois, 17099, 112579, 50633, 49935, 123100, 32356, 19148, 13208
Lawrence County, Illinois, 17101, 16665, 40841, 5921, 66700, 3857, 1703, 2154
Lee County, Illinois, 17103, 35027, 52379, 15047, 113600, 10011, 5684, 4327
Livingston County, Illinois, 17105, 37689, 54254, 15847, 107200, 10578, 6005, 4573
Logan County, Illinois, 17107, 29956, 50539, 11722, 98900, 7263, 4233, 3030
McDonough County, Illinois, 17109, 32009, 40314, 14403, 89900, 7725, 4166, 3559
McHenry County, Illinois, 17111, 307357, 77222, 116772, 208200, 88257, 67663, 20594
McLean County, Illinois, 17113, 173114, 62211, 70897, 160500, 42905, 29606, 13299
Macon County, Illinois, 17115, 109193, 47176, 50391, 94900, 30995, 17094, 13901
Macoupin County, Illinois, 17117, 46844, 51206, 21558, 94300, 14724, 8552, 6172
Madison County, Illinois, 17119, 267356, 53431, 117919, 126500, 75940, 48380, 27560
Marion County, Illinois, 17121, 38665, 42238, 18195, 68600, 11777, 6453, 5324
Marshall County, Illinois, 17123, 12173, 53423, 5912, 104600, 4155, 2163, 1992
Mason County, Illinois, 17125, 14126, 41567, 7030, 81300, 4705, 2291, 2414
Massac County, Illinois, 17127, 15016, 40977, 7097, 83900, 4365, 2170, 2195
Menard County, Illinois, 17129, 12611, 60486, 5651, 127900, 3999, 2594, 1405
Mercer County, Illinois, 17131, 16107, 54757, 7359, 98000, 5159, 2887, 2272
Monroe County, Illinois, 17133, 33539, 70859, 13678, 191200, 10428, 6885, 3543
Montgomery County, Illinois, 17135, 29348, 46966, 12758, 78300, 8551, 4645, 3906
Morgan County, Illinois, 17137, 35129, 45978, 15449, 98500, 9579, 5668, 3911
Moultrie County, Illinois, 17139, 14927, 49681, 6325, 100900, 4418, 2553, 1865
Ogle County, Illinois, 17141, 52397, 54849, 22583, 140000, 15732, 10029, 5703
Peoria County, Illinois, 17143, 187112, 51147, 83476, 126600, 49289, 31024, 18265
Perry County, Illinois, 17145, 21810, 42478, 9454, 78400, 6094, 2982, 3112
Piatt County, Illinois, 17147, 16495, 66261, 7321, 123600, 5549, 3420, 2129
Pike County, Illinois, 17149, 16144, 40588, 7941, 75300, 5172, 2697, 2475
Pope County, Illinois, 17151, 4331, 39223, 2652, 102000, 1329, 512, 817
Pulaski County, Illinois, 17153, 5871, 31980, 3139, 57600, 1744, 716, 1028
Putnam County, Illinois, 17155, 5822, 56358, 3106, 121300, 1965, 1111, 854
Randolph County, Illinois, 17157, 33069, 48158, 13762, 96700, 9209, 4612, 4597
Richland County, Illinois, 17159, 16127, 44127, 7492, 83800, 4675, 2020, 2655
Rock Island County, Illinois, 17161, 147161, 48817, 65791, 113800, 41981, 24325, 17656
St. Clair County, Illinois, 17163, 267029, 49895, 117949, 120400, 67779, 42230, 25549
Saline County, Illinois, 17165, 24783, 38258, 11644, 69400, 7115, 3204, 3911
Sangamon County, Illinois, 17167, 199016, 56167, 90433, 130900, 57654, 36651, 21003
Schuyler County, Illinois, 17169, 7311, 47723, 3441, 78100, 2446, 1145, 1301
Scott County, Illinois, 17171, 5198, 47222, 2435, 84300, 1607, 804, 803
Shelby County, Illinois, 17173, 22115, 47850, 10450, 85300, 7379, 3454, 3925
Stark County, Illinois, 17175, 5859, 50085, 2662, 85100, 1966, 836, 1130
Stephenson County, Illinois, 17177, 46625, 45331, 21957, 98900, 13641, 7489, 6152
Tazewell County, Illinois, 17179, 135697, 58194, 57958, 134900, 41508, 25866, 15642
Union County, Illinois, 17181, 17551, 42606, 7914, 93900, 5278, 2582, 2696
Vermilion County, Illinois, 17183, 80368, 42977, 36093, 75800, 21751, 10943, 10808
Wabash County, Illinois, 17185, 11652, 47491, 5539, 81100, 3581, 1779, 1802
Warren County, Illinois, 17187, 17701, 43699, 7690, 81900, 5166, 2774, 2392
Washington County, Illinois, 17189, 14457, 53202, 6575, 106600, 4553, 2211, 2342
Wayne County, Illinois, 17191, 16555, 44993, 7905, 77800, 5650, 2641, 3009
White County, Illinois, 17193, 14464, 44648, 7129, 70900, 4603, 2069, 2534
Whiteside County, Illinois, 17195, 57525, 47401, 25750, 99200, 17731, 10171, 7560
Will County, Illinois, 17197, 683995, 76101, 239232, 209800, 182276, 137079, 45197
Williamson County, Illinois, 17199, 67121, 44453, 30688, 99200, 19430, 11006, 8424
Winnebago County, Illinois, 17201, 290439, 48225, 125720, 117700, 75502, 50493, 25009
Woodford County, Illinois, 17203, 39106, 65852, 15325, 158200, 11663, 7191, 4472
Adams County, Indiana, 18001, 34642, 48188, 13079, 116900, 9548, 5753, 3795
Allen County, Indiana, 18003, 363453, 49092, 153860, 114600, 96765, 65524, 31241
Bartholomew County, Indiana, 18005, 79488, 55050, 33422, 136000, 21588, 14099, 7489
Benton County, Indiana, 18007, 8752, 47046, 3907, 83800, 2426, 1397, 1029
Blackford County, Indiana, 18009, 12476, 38190, 6008, 67500, 3877, 2199, 1678
Boone County, Indiana, 18011, 60511, 67552, 24565, 187600, 17396, 13024, 4372
Brown County, Indiana, 18013, 15011, 54615, 8479, 162300, 4842, 3090, 1752
Carroll County, Indiana, 18015, 20014, 52005, 9456, 112100, 6275, 3901, 2374
Cass County, Indiana, 18017, 38476, 42290, 16374, 82400, 10975, 6456, 4519
Clark County, Indiana, 18019, 113181, 51699, 48626, 129000, 30563, 21118, 9445
Clay County, Indiana, 18021, 26686, 47602, 11693, 95000, 7782, 5009, 2773
Clinton County, Indiana, 18023, 32835, 48478, 13253, 98100, 8434, 5307, 3127
Crawford County, Indiana, 18025, 10591, 38695, 5460, 86300, 3250, 1750, 1500
Daviess County, Indiana, 18027, 32411, 47342, 12462, 110200, 8287, 4770, 3517
Dearborn County, Indiana, 18029, 49679, 58680, 20231, 159100, 14646, 10574, 4072
Decatur County, Indiana, 18031, 26240, 49799, 11217, 115100, 7076, 4496, 2580
DeKalb County, Indiana, 18033, 42449, 48341, 17604, 110100, 12496, 8096, 4400
Delaware County, Indiana, 18035, 117335, 38830, 52348, 87700, 29208, 18415, 10793
Dubois County, Indiana, 18037, 42291, 53513, 17540, 137700, 12263, 7000, 5263
Elkhart County, Indiana, 18039, 200685, 47913, 77880, 124000, 48955, 33291, 15664
Fayette County, Indiana, 18041, 23773, 39379, 10831, 81900, 6429, 3983, 2446
Floyd County, Indiana, 18043, 75900, 54914, 32223, 156300, 21055, 14275, 6780
Fountain County, Indiana, 18045, 16888, 46760, 7810, 87500, 5193, 2928, 2265
Franklin County, Indiana, 18047, 22935, 51748, 9553, 147600, 7071, 4371, 2700
Fulton County, Indiana, 18049, 20527, 45332, 9663, 95400, 6127, 3744, 2383
Gibson County, Indiana, 18051, 33668, 48303, 14696, 103000, 10127, 5958, 4169
Grant County, Indiana, 18053, 68896, 40294, 30331, 82800, 18451, 11085, 7366
Greene County, Indiana, 18055, 32815, 45397, 15102, 90500, 10119, 5521, 4598
Hamilton County, Indiana, 18057, 296635, 86222, 113759, 222900, 84806, 68539, 16267
Hancock County, Indiana, 18059, 71328, 66606, 28685, 156300, 20608, 15449, 5159
Harrison County, Indiana, 18061, 39230, 52128, 16636, 129300, 11905, 7622, 4283
Hendricks County, Indiana, 18063, 153435, 70163, 57616, 162400, 43851, 34097, 9754
Henry County, Indiana, 18065, 49146, 41855, 21171, 91600, 13231, 7905, 5326
Howard County, Indiana, 18067, 82765, 44226, 38649, 95700, 23731, 15640, 8091
Huntington County, Indiana, 18069, 36863, 46945, 15864, 99900, 10973, 7359, 3614
Jackson County, Indiana, 18071, 43471, 47000, 18432, 112200, 12325, 7850, 4475
Jasper County, Indiana, 18073, 33448, 55374, 13302, 148300, 9306, 5918, 3388
Jay County, Indiana, 18075, 21255, 41021, 9202, 79400, 6075, 3570, 2505
Jefferson County, Indiana, 18077, 32453, 45718, 14315, 112100, 9120, 5826, 3294
Jennings County, Indiana, 18079, 28113, 44736, 12062, 95400, 8035, 4799, 3236
Johnson County, Indiana, 18081, 145645, 62147, 58189, 145400, 37734, 28631, 9103
Knox County, Indiana, 18083, 38062, 42725, 16997, 84700, 9755, 5670, 4085
Kosciusko County, Indiana, 18085, 77983, 52821, 37418, 132900, 22634, 14575, 8059
LaGrange County, Indiana, 18087, 38084, 49964, 14283, 162200, 9513, 6178, 3335
Lake County, Indiana, 18089, 491596, 50135, 209868, 136100, 126228, 84458, 41770
LaPorte County, Indiana, 18091, 111280, 46872, 48682, 123300, 30343, 19476, 10867
Lawrence County, Indiana, 18093, 45814, 45875, 20965, 100500, 14245, 8795, 5450
Madison County, Indiana, 18095, 130280, 44195, 58844, 90400, 35412, 22972, 12440
Marion County, Indiana, 18097, 926335, 42168, 419109, 118300, 197290, 143533, 53757
Marshall County, Indiana, 18099, 46962, 48485, 19948, 123100, 13319, 8337, 4982
Martin County, Indiana, 18101, 10262, 44589, 4753, 91800, 3274, 1861, 1413
Miami County, Indiana, 18103, 36211, 45184, 15363, 85500, 9606, 5896, 3710
Monroe County, Indiana, 18105, 142404, 42404, 59808, 160400, 29050, 19096, 9954
Montgomery County, Indiana, 18107, 38172, 48213, 16527, 110600, 10398, 7180, 3218
Morgan County, Indiana, 18109, 69403, 55432, 27914, 143700, 19554, 13475, 6079
Newton County, Indiana, 18111, 14057, 46895, 6040, 113400, 4062, 2576, 1486
Noble County, Indiana, 18113, 47546, 49331, 20155, 113000, 13592, 8659, 4933
Ohio County, Indiana, 18115, 6033, 48780, 2799, 141000, 1880, 1264, 616
Orange County, Indiana, 18117, 19725, 39812, 9123, 89400, 5833, 3227, 2606
Owen County, Indiana, 18119, 21192, 43948, 9995, 110200, 6812, 4004, 2808
Parke County, Indiana, 18121, 17107, 40781, 8062, 88200, 4786, 2798, 1988
Perry County, Indiana, 18123, 19414, 47470, 8519, 100800, 5796, 3418, 2378
Pike County, Indiana, 18125, 12687, 44399, 5755, 88400, 4096, 2187, 1909
Porter County, Indiana, 18127, 166570, 63926, 66786, 165500, 47809, 33197, 14612
Posey County, Indiana, 18129, 25567, 58101, 11301, 133800, 8395, 5403, 2992
Pulaski County, Indiana, 18131, 13047, 43836, 6043, 93000, 3969, 2289, 1680
Putnam County, Indiana, 18133, 37650, 51355, 14774, 122800, 9320, 6117, 3203
Randolph County, Indiana, 18135, 25596, 40810, 11657, 78200, 7758, 4489, 3269
Ripley County, Indiana, 18137, 28612, 51170, 12081, 129800, 8437, 5710, 2727
Rush County, Indiana, 18139, 16991, 45121, 7479, 100700, 4959, 3079, 1880
St. Joseph County, Indiana, 18141, 267246, 45471, 115351, 114800, 69843, 45658, 24185
Scott County, Indiana, 18143, 23783, 44442, 10443, 98700, 6497, 3979, 2518
Shelby County, Indiana, 18145, 44441, 53584, 19080, 120800, 12430, 8133, 4297
Spencer County, Indiana, 18147, 20856, 55247, 8919, 116100, 6547, 3957, 2590
Starke County, Indiana, 18149, 23117, 42208, 10985, 96900, 7123, 4454, 2669
Steuben County, Indiana, 18151, 34267, 48472, 19474, 128800, 10457, 6502, 3955
Sullivan County, Indiana, 18153, 21111, 45023, 8874, 78200, 5589, 3277, 2312
Switzerland County, Indiana, 18155, 10500, 44061, 5054, 119100, 2909, 1867, 1042
Tippecanoe County, Indiana, 18157, 180952, 45932, 73136, 135200, 35766, 25664, 10102
Tipton County, Indiana, 18159, 15573, 51613, 6966, 111500, 4976, 3044, 1932
Union County, Indiana, 18161, 7299, 44277, 3226, 102500, 2132, 1384, 748
Vanderburgh County, Indiana, 18163, 181305, 43046, 83329, 115500, 46954, 31023, 15931
Vermillion County, Indiana, 18165, 15860, 43600, 7466, 75000, 4982, 2831, 2151
Vigo County, Indiana, 18167, 108268, 40313, 46353, 91200, 24497, 15795, 8702
Wabash County, Indiana, 18169, 32358, 45649, 14122, 95100, 9561, 5831, 3730
Warren County, Indiana, 18171, 8367, 56042, 3673, 107200, 2662, 1600, 1062
Warrick County, Indiana, 18173, 60995, 62185, 24727, 148400, 18696, 12387, 6309
Washington County, Indiana, 18175, 27930, 41289, 12188, 102900, 8088, 5100, 2988
Wayne County, Indiana, 18177, 67866, 38494, 31215, 92200, 18596, 11911, 6685
Wells County, Indiana, 18179, 27796, 51101, 11684, 115200, 8791, 5842, 2949
White County, Indiana, 18181, 24388, 52154, 12964, 105500, 7361, 4522, 2839
Whitley County, Indiana, 18183, 33330, 54389, 14421, 130400, 10832, 7536, 3296
Adair County, Iowa, 19001, 7426, 46526, 3672, 89600, 2484, 1229, 1255
Adams County, Iowa, 19003, 3892, 48043, 1992, 87800, 1254, 606, 648
Allamakee County, Iowa, 19005, 14060, 45890, 7626, 110900, 4681, 2212, 2469
Appanoose County, Iowa, 19007, 12669, 41394, 6596, 78200, 3973, 1871, 2102
Audubon County, Iowa, 19009, 5869, 46979, 3005, 65000, 2191, 935, 1256
Benton County, Iowa, 19011, 25803, 60606, 11082, 140600, 8248, 4984, 3264
Black Hawk County, Iowa, 19013, 132496, 48369, 56591, 130200, 35358, 22140, 13218
Boone County, Iowa, 19015, 26401, 52985, 11789, 119600, 8114, 4959, 3155
Bremer County, Iowa, 19017, 24539, 62163, 10067, 151600, 7563, 4620, 2943
Buchanan County, Iowa, 19019, 20998, 56150, 8989, 126600, 6576, 3918, 2658
Buena Vista County, Iowa, 19021, 20507, 48195, 8263, 103900, 5263, 2866, 2397
Butler County, Iowa, 19023, 14966, 52360, 6707, 107400, 4957, 2627, 2330
Calhoun County, Iowa, 19025, 9914, 44921, 5094, 76100, 3274, 1628, 1646
Carroll County, Iowa, 19027, 20629, 50559, 9398, 113200, 6382, 3418, 2964
Cass County, Iowa, 19029, 13590, 43750, 6559, 89500, 4327, 2295, 2032
Cedar County, Iowa, 19031, 18375, 59047, 8111, 134700, 6084, 3691, 2393
Cerro Gordo County, Iowa, 19033, 43481, 46122, 22215, 115200, 13867, 7777, 6090
Cherokee County, Iowa, 19035, 11853, 48599, 5766, 84200, 3934, 1797, 2137
Chickasaw County, Iowa, 19037, 12244, 47040, 5658, 103400, 4146, 2084, 2062
Clarke County, Iowa, 19039, 9280, 43327, 4126, 91200, 2612, 1448, 1164
Clay County, Iowa, 19041, 16537, 50389, 8069, 110500, 5323, 3073, 2250
Clayton County, Iowa, 19043, 17806, 48007, 9025, 106700, 5966, 3031, 2935
Clinton County, Iowa, 19045, 48365, 50498, 21760, 110100, 14780, 8746, 6034
Crawford County, Iowa, 19047, 17252, 48084, 6981, 90200, 4774, 2378, 2396
Dallas County, Iowa, 19049, 74892, 76320, 29257, 190700, 21134, 15948, 5186
Davis County, Iowa, 19051, 8742, 48888, 3583, 99900, 2510, 1234, 1276
Decatur County, Iowa, 19053, 8249, 38560, 3847, 81500, 2108, 1038, 1070
Delaware County, Iowa, 19055, 17507, 58274, 8031, 123300, 5579, 3157, 2422
Des Moines County, Iowa, 19057, 40208, 44423, 18477, 98200, 12336, 6779, 5557
Dickinson County, Iowa, 19059, 16967, 57265, 13087, 167800, 5891, 3257, 2634
Dubuque County, Iowa, 19061, 95906, 54605, 40077, 149400, 27445, 16589, 10856
Emmet County, Iowa, 19063, 9917, 47795, 4765, 84100, 3189, 1497, 1692
Fayette County, Iowa, 19065, 20589, 44928, 9554, 88200, 6444, 3340, 3104
Floyd County, Iowa, 19067, 16050, 44797, 7524, 98200, 4967, 2706, 2261
Franklin County, Iowa, 19069, 10489, 48605, 4865, 85900, 3159, 1571, 1588
Fremont County, Iowa, 19071, 7106, 53324, 3432, 100100, 2240, 1216, 1024
Greene County, Iowa, 19073, 9174, 46898, 4539, 85300, 2982, 1608, 1374
Grundy County, Iowa, 19075, 12407, 56750, 5538, 125700, 4174, 2312, 1862
Guthrie County, Iowa, 19077, 10740, 51013, 5741, 103700, 3634, 1904, 1730
Hamilton County, Iowa, 19079, 15297, 49813, 7184, 93600, 4465, 2718, 1747
Hancock County, Iowa, 19081, 11092, 52981, 5288, 91600, 3744, 1807, 1937
Hardin County, Iowa, 19083, 17393, 51019, 8180, 88700, 5267, 2780, 2487
Harrison County, Iowa, 19085, 14467, 53567, 6727, 106400, 4477, 2612, 1865
Henry County, Iowa, 19087, 20080, 49321, 8251, 103900, 5555, 3047, 2508
Howard County, Iowa, 19089, 9494, 49869, 4366, 94600, 3077, 1648, 1429
Humboldt County, Iowa, 19091, 9674, 47252, 4671, 89800, 3027, 1498, 1529
Ida County, Iowa, 19093, 7071, 46993, 3410, 80300, 2332, 1254, 1078
Iowa County, Iowa, 19095, 16344, 59375, 7255, 138700, 5322, 3077, 2245
Jackson County, Iowa, 19097, 19572, 49028, 9429, 114300, 6324, 3282, 3042
Jasper County, Iowa, 19099, 36726, 55033, 16158, 117700, 10543, 6201, 4342
Jefferson County, Iowa, 19101, 17318, 42899, 7557, 101000, 4598, 2335, 2263
Johnson County, Iowa, 19103, 139436, 55700, 57997, 193600, 32973, 22845, 10128
Jones County, Iowa, 19105, 20560, 55060, 8902, 129300, 6389, 3661, 2728
Keokuk County, Iowa, 19107, 10291, 43838, 4899, 77100, 3375, 1645, 1730
Kossuth County, Iowa, 19109, 15280, 51496, 7483, 92300, 5289, 2632, 2657
Lee County, Iowa, 19111, 35369, 43312, 16217, 85400, 10723, 5574, 5149
Linn County, Iowa, 19113, 216640, 59322, 94058, 147400, 64274, 44093, 20181
Louisa County, Iowa, 19115, 11271, 51144, 5016, 99900, 3354, 1839, 1515
Lucas County, Iowa, 19117, 8731, 43962, 4208, 82400, 2915, 1604, 1311
Lyon County, Iowa, 19119, 11723, 57130, 4924, 111100, 3722, 2070, 1652
Madison County, Iowa, 19121, 15644, 60060, 6667, 160200, 4660, 3024, 1636
Mahaska County, Iowa, 19123, 22396, 48726, 9759, 106200, 6340, 3636, 2704
Marion County, Iowa, 19125, 33248, 54693, 13986, 137300, 9610, 6052, 3558
Marshall County, Iowa, 19127, 40962, 53351, 16736, 104500, 11086, 6639, 4447
Mills County, Iowa, 19129, 14862, 63979, 6082, 153100, 4319, 2877, 1442
Mitchell County, Iowa, 19131, 10762, 49488, 4897, 108700, 3646, 1812, 1834
Monona County, Iowa, 19133, 9088, 40302, 4719, 79400, 2885, 1388, 1497
Monroe County, Iowa, 19135, 8002, 46304, 3896, 96300, 2482, 1148, 1334
Montgomery County, Iowa, 19137, 10465, 42418, 5207, 78700, 3166, 1542, 1624
Muscatine County, Iowa, 19139, 42913, 53676, 17955, 126900, 12086, 7244, 4842
O'Brien County, Iowa, 19141, 14092, 55227, 6632, 102700, 4440, 2226, 2214
Osceola County, Iowa, 19143, 6211, 49448, 2974, 83600, 2091, 877, 1214
Page County, Iowa, 19145, 15660, 43912, 7185, 82500, 4681, 2407, 2274
Palo Alto County, Iowa, 19147, 9208, 47113, 4611, 85300, 2958, 1511, 1447
Plymouth County, Iowa, 19149, 24853, 57130, 10624, 138300, 7913, 4460, 3453
Pocahontas County, Iowa, 19151, 7127, 45069, 3763, 64700, 2471, 1017, 1454
Polk County, Iowa, 19153, 452369, 60061, 189320, 157200, 119646, 87026, 32620
Pottawattamie County, Iowa, 19155, 93213, 51976, 39532, 125800, 25441, 16426, 9015
Poweshiek County, Iowa, 19157, 18705, 51006, 8968, 128700, 5235, 2916, 2319
Ringgold County, Iowa, 19159, 5061, 47042, 2602, 77600, 1574, 732, 842
Sac County, Iowa, 19161, 10101, 49572, 5409, 81200, 3529, 1671, 1858
Scott County, Iowa, 19163, 169994, 55114, 72800, 148200, 46076, 31422, 14654
Shelby County, Iowa, 19165, 11992, 50952, 5553, 108800, 4015, 2040, 1975
Sioux County, Iowa, 19167, 34509, 61627, 12504, 140900, 9285, 5423, 3862
Story County, Iowa, 19169, 93586, 50438, 37688, 166000, 19186, 12104, 7082
Tama County, Iowa, 19171, 17479, 55203, 7745, 103000, 5230, 2616, 2614
Taylor County, Iowa, 19173, 6213, 44246, 3086, 70400, 1968, 928, 1040
Union County, Iowa, 19175, 12575, 44351, 5910, 87200, 3799, 2217, 1582
Van Buren County, Iowa, 19177, 7432, 45111, 3639, 76300, 2521, 1188, 1333
Wapello County, Iowa, 19179, 35315, 42095, 16017, 80400, 10603, 5815, 4788
Warren County, Iowa, 19181, 47542, 64447, 18951, 159900, 13873, 9695, 4178
Washington County, Iowa, 19183, 22017, 56390, 9529, 122100, 6426, 3871, 2555
Wayne County, Iowa, 19185, 6384, 43358, 3196, 70600, 2110, 996, 1114
Webster County, Iowa, 19187, 37295, 42408, 17006, 85900, 10257, 5604, 4653
Winnebago County, Iowa, 19189, 10614, 47668, 5179, 94100, 3453, 1792, 1661
Winneshiek County, Iowa, 19191, 20884, 54429, 8777, 157800, 6349, 3625, 2724
Woodbury County, Iowa, 19193, 102530, 46720, 41488, 99600, 26098, 15298, 10800
Worth County, Iowa, 19195, 7563, 48459, 3524, 96400, 2492, 1171, 1321
Wright County, Iowa, 19197, 12936, 43698, 6510, 73400, 4140, 2014, 2126
Allen County, Kansas, 20001, 13081, 38698, 6247, 68200, 3848, 1830, 2018
Anderson County, Kansas, 20003, 7896, 40696, 3712, 90400, 2473, 1220, 1253
Atchison County, Kansas, 20005, 16633, 43581, 6958, 88100, 4363, 2374, 1989
Barber County, Kansas, 20007, 4770, 51811, 2792, 78100, 1448, 592, 856
Barton County, Kansas, 20009, 27399, 44013, 12617, 81200, 7624, 3549, 4075
Bourbon County, Kansas, 20011, 14812, 38280, 7114, 81400, 3901, 1794, 2107
Brown County, Kansas, 20013, 9880, 43724, 4768, 84600, 2809, 1372, 1437
Butler County, Kansas, 20015, 66092, 58897, 26329, 134500, 17758, 11802, 5956
Chase County, Kansas, 20017, 2722, 38707, 1496, 76600, 825, 383, 442
Chautauqua County, Kansas, 20019, 3520, 37993, 2134, 48500, 1228, 415, 813
Cherokee County, Kansas, 20021, 20952, 41388, 9837, 72500, 6043, 2640, 3403
Cheyenne County, Kansas, 20023, 2682, 44500, 1496, 82800, 1009, 396, 613
Clark County, Kansas, 20025, 2145, 42589, 1162, 62200, 650, 284, 366
Clay County, Kansas, 20027, 8421, 52066, 4052, 96500, 2749, 1309, 1440
Cloud County, Kansas, 20029, 9339, 39282, 4637, 69000, 2853, 979, 1874
Coffey County, Kansas, 20031, 8458, 57433, 3999, 102000, 2707, 1551, 1156
Comanche County, Kansas, 20033, 2010, 45288, 993, 61800, 604, 190, 414
Cowley County, Kansas, 20035, 36079, 43860, 15995, 83200, 9245, 4858, 4387
Crawford County, Kansas, 20037, 39304, 36534, 17864, 85900, 9203, 4985, 4218
Decatur County, Kansas, 20039, 2905, 40657, 1812, 55900, 1126, 421, 705
Dickinson County, Kansas, 20041, 19516, 49096, 9066, 108200, 5712, 3106, 2606
Doniphan County, Kansas, 20043, 7859, 47209, 3556, 86900, 2241, 1100, 1141
Douglas County, Kansas, 20045, 114967, 50939, 47812, 179800, 22806, 16100, 6706
Edwards County, Kansas, 20047, 2991, 47303, 1630, 56400, 961, 310, 651
Elk County, Kansas, 20049, 2683, 36458, 1740, 49200, 987, 359, 628
Ellis County, Kansas, 20051, 28993, 45579, 12996, 150200, 7531, 4216, 3315
Ellsworth County, Kansas, 20053, 6410, 47736, 3219, 81400, 1960, 1009, 951
Finney County, Kansas, 20055, 37133, 49227, 13290, 117000, 7830, 4564, 3266
Ford County, Kansas, 20057, 34714, 50777, 12081, 99500, 6859, 3751, 3108
Franklin County, Kansas, 20059, 25753, 51081, 11114, 122900, 7058, 4524, 2534
Geary County, Kansas, 20061, 36787, 43992, 15009, 136000, 5442, 3485, 1957
Gove County, Kansas, 20063, 2735, 46364, 1383, 76300, 932, 353, 579
Graham County, Kansas, 20065, 2593, 43826, 1479, 68600, 957, 341, 616
Grant County, Kansas, 20067, 7816, 55432, 2934, 99400, 2102, 987, 1115
Gray County, Kansas, 20069, 6065, 61000, 2388, 107900, 1566, 727, 839
Greeley County, Kansas, 20071, 1224, 47750, 588, 84500, 348, 108, 240
Greenwood County, Kansas, 20073, 6393, 38838, 4052, 57200, 2185, 889, 1296
Hamilton County, Kansas, 20075, 2586, 45114, 1195, 86600, 719, 296, 423
Harper County, Kansas, 20077, 5861, 43973, 3148, 66900, 1854, 766, 1088
Harvey County, Kansas, 20079, 34835, 51327, 14602, 115800, 9486, 5505, 3981
Haskell County, Kansas, 20081, 4130, 56484, 1660, 116000, 1010, 484, 526
Hodgeman County, Kansas, 20083, 1939, 54856, 1034, 82900, 596, 209, 387
Jackson County, Kansas, 20085, 13400, 54077, 5764, 119400, 3974, 2275, 1699
Jefferson County, Kansas, 20087, 18898, 57236, 8210, 127100, 6182, 3741, 2441
Jewell County, Kansas, 20089, 3038, 40553, 2028, 53100, 1150, 330, 820
Johnson County, Kansas, 20091, 566814, 76113, 231029, 215600, 152762, 112855, 39907
Kearny County, Kansas, 20093, 3952, 50506, 1556, 94100, 1031, 612, 419
Kingman County, Kansas, 20095, 7790, 50844, 3811, 88000, 2205, 1093, 1112
Kiowa County, Kansas, 20097, 2536, 43963, 1227, 121300, 693, 279, 414
Labette County, Kansas, 20099, 21048, 41439, 10070, 70200, 5833, 2814, 3019
Lane County, Kansas, 20101, 1674, 56507, 955, 66200, 614, 316, 298
Leavenworth County, Kansas, 20103, 78227, 63726, 28999, 167500, 17772, 11711, 6061
Lincoln County, Kansas, 20105, 3154, 44276, 1859, 66900, 1055, 435, 620
Linn County, Kansas, 20107, 9528, 46964, 5446, 90300, 3257, 1863, 1394
Logan County, Kansas, 20109, 2793, 46875, 1443, 79200, 880, 373, 507
Lyon County, Kansas, 20111, 33462, 40021, 15218, 93400, 7929, 4575, 3354
McPherson County, Kansas, 20113, 29252, 56128, 12824, 132900, 8959, 5503, 3456
Marion County, Kansas, 20115, 12290, 45927, 5930, 81600, 3817, 1917, 1900
Marshall County, Kansas, 20117, 10005, 45374, 4882, 86700, 3196, 1339, 1857
Meade County, Kansas, 20119, 4383, 52250, 1943, 86500, 1203, 520, 683
Miami County, Kansas, 20121, 32688, 60966, 13273, 167400, 9718, 6529, 3189
Mitchell County, Kansas, 20123, 6296, 48217, 3290, 89000, 1950, 933, 1017
Montgomery County, Kansas, 20125, 34184, 41083, 16474, 70600, 9339, 4723, 4616
Morris County, Kansas, 20127, 5750, 47089, 3195, 85200, 1846, 743, 1103
Morton County, Kansas, 20129, 3106, 46028, 1458, 99400, 835, 380, 455
Nemaha County, Kansas, 20131, 10159, 48653, 4571, 109900, 3254, 1588, 1666
Neosho County, Kansas, 20133, 16423, 43195, 7653, 69800, 4615, 2200, 2415
Ness County, Kansas, 20135, 3077, 44904, 1741, 67100, 1084, 341, 743
Norton County, Kansas, 20137, 5590, 47852, 2535, 72900, 1644, 907, 737
Osage County, Kansas, 20139, 16080, 49915, 7501, 98300, 4910, 2832, 2078
Osborne County, Kansas, 20141, 3782, 40216, 2198, 57400, 1322, 489, 833
Ottawa County, Kansas, 20143, 6048, 52479, 2769, 92600, 2064, 1187, 877
Pawnee County, Kansas, 20145, 6911, 43250, 3165, 77400, 1773, 795, 978
Phillips County, Kansas, 20147, 5501, 44170, 3044, 72700, 1808, 779, 1029
Pottawatomie County, Kansas, 20149, 22625, 60216, 8918, 160700, 6395, 3974, 2421
Pratt County, Kansas, 20151, 9739, 49550, 4485, 85900, 2687, 1245, 1442
Rawlins County, Kansas, 20153, 2545, 41579, 1458, 75600, 868, 283, 585
Reno County, Kansas, 20155, 64058, 45288, 28274, 94100, 16855, 9542, 7313
Republic County, Kansas, 20157, 4806, 40449, 2877, 48900, 1785, 609, 1176
Rice County, Kansas, 20159, 10014, 48460, 4548, 75300, 2911, 1428, 1483
Riley County, Kansas, 20161, 75022, 44437, 29557, 181200, 11050, 6886, 4164
Rooks County, Kansas, 20163, 5186, 43558, 2757, 67900, 1649, 747, 902
Rush County, Kansas, 20165, 3184, 38854, 1797, 62100, 1168, 455, 713
Russell County, Kansas, 20167, 6988, 41102, 3892, 81000, 2428, 1210, 1218
Saline County, Kansas, 20169, 55735, 47801, 24192, 122200, 14704, 9296, 5408
Scott County, Kansas, 20171, 4928, 51850, 2373, 126000, 1583, 714, 869
Sedgwick County, Kansas, 20173, 506529, 50657, 213700, 126500, 123624, 80394, 43230
Seward County, Kansas, 20175, 23274, 47134, 8110, 87100, 5060, 2780, 2280
Shawnee County, Kansas, 20177, 178792, 50378, 79425, 122200, 45873, 28901, 16972
Sheridan County, Kansas, 20179, 2531, 49750, 1263, 91400, 887, 276, 611
Sherman County, Kansas, 20181, 6054, 39029, 3124, 77000, 1620, 833, 787
Smith County, Kansas, 20183, 3740, 43848, 2240, 64000, 1338, 428, 910
Stafford County, Kansas, 20185, 4320, 47377, 2303, 65100, 1503, 552, 951
Stanton County, Kansas, 20187, 2149, 43780, 1014, 73800, 640, 316, 324
Stevens County, Kansas, 20189, 5772, 55433, 2294, 96400, 1504, 721, 783
Sumner County, Kansas, 20191, 23638, 50141, 10855, 83900, 7057, 3833, 3224
Thomas County, Kansas, 20193, 7925, 48504, 3539, 105100, 2211, 1060, 1151
Trego County, Kansas, 20195, 2951, 54000, 1665, 86900, 1004, 460, 544
Wabaunsee County, Kansas, 20197, 6997, 54688, 3241, 115300, 2293, 1345, 948
Wallace County, Kansas, 20199, 1595, 47279, 813, 76300, 475, 155, 320
Washington County, Kansas, 20201, 5686, 45159, 2956, 68800, 1961, 734, 1227
Wichita County, Kansas, 20203, 2204, 57171, 868, 70600, 564, 173, 391
Wilson County, Kansas, 20205, 9061, 40306, 4663, 60100, 2808, 1369, 1439
Woodson County, Kansas, 20207, 3211, 35787, 2007, 48300, 1218, 438, 780
Wyandotte County, Kansas, 20209, 160806, 40113, 67113, 89200, 34559, 21192, 13367
Adair County, Kentucky, 21001, 18852, 33362, 8526, 82400, 5189, 2560, 2629
Allen County, Kentucky, 21003, 20355, 41326, 9323, 95500, 5665, 2912, 2753
Anderson County, Kentucky, 21005, 21761, 53974, 9222, 136800, 6501, 4686, 1815
Ballard County, Kentucky, 21007, 8256, 42244, 3889, 101800, 2678, 1332, 1346
Barren County, Kentucky, 21009, 42925, 38370, 19372, 105800, 11454, 6603, 4851
Bath County, Kentucky, 21011, 11978, 33483, 5390, 73500, 3205, 1602, 1603
Bell County, Kentucky, 21013, 27950, 22443, 13109, 60400, 7341, 2736, 4605
Boone County, Kentucky, 21015, 124617, 66730, 47466, 175100, 32785, 25085, 7700
Bourbon County, Kentucky, 21017, 20013, 45208, 8990, 139600, 4866, 3231, 1635
Boyd County, Kentucky, 21019, 48917, 42319, 21717, 99700, 13615, 7370, 6245
Boyle County, Kentucky, 21021, 29388, 39704, 12385, 132500, 7235, 4338, 2897
Bracken County, Kentucky, 21023, 8425, 36327, 3827, 95800, 2517, 1408, 1109
Breathitt County, Kentucky, 21025, 13591, 25817, 6206, 47500, 4051, 1133, 2918
Breckinridge County, Kentucky, 21027, 20061, 43479, 10615, 88000, 5784, 2813, 2971
Bullitt County, Kentucky, 21029, 76961, 55975, 30175, 144700, 22946, 15959, 6987
Butler County, Kentucky, 21031, 12835, 33536, 5861, 90800, 3799, 1586, 2213
Caldwell County, Kentucky, 21033, 12826, 42537, 6271, 96700, 3767, 1881, 1886
Calloway County, Kentucky, 21035, 38106, 37034, 18237, 119900, 9355, 5009, 4346
Campbell County, Kentucky, 21037, 91475, 54621, 39754, 150400, 24368, 17303, 7065
Carlisle County, Kentucky, 21039, 4984, 38829, 2426, 77200, 1630, 747, 883
Carroll County, Kentucky, 21041, 10830, 41439, 4687, 99200, 2424, 1421, 1003
Carter County, Kentucky, 21043, 27326, 36696, 12285, 77100, 8182, 3727, 4455
Casey County, Kentucky, 21045, 15954, 32341, 7429, 76500, 5088, 2284, 2804
Christian County, Kentucky, 21047, 74159, 39521, 29633, 108500, 12178, 6865, 5313
Clark County, Kentucky, 21049, 35657, 47959, 15744, 142700, 9094, 6090, 3004
Clay County, Kentucky, 21051, 21300, 21549, 8866, 56300, 5713, 2047, 3666
Clinton County, Kentucky, 21053, 10188, 28025, 5264, 65300, 2892, 1073, 1819
Crittenden County, Kentucky, 21055, 9222, 35316, 4561, 76000, 2927, 1251, 1676
Cumberland County, Kentucky, 21057, 6807, 32019, 3658, 63500, 1969, 772, 1197
Daviess County, Kentucky, 21059, 98173, 45989, 42217, 115400, 26615, 16057, 10558
Edmonson County, Kentucky, 21061, 12105, 41710, 6452, 88800, 3800, 2101, 1699
Elliott County, Kentucky, 21063, 7725, 28224, 3364, 66100, 2179, 788, 1391
Estill County, Kentucky, 21065, 14476, 29770, 6860, 71400, 4011, 1772, 2239
Fayette County, Kentucky, 21067, 308306, 49778, 137885, 168100, 68194, 48977, 19217
Fleming County, Kentucky, 21069, 14544, 35469, 6612, 86700, 4258, 2280, 1978
Floyd County, Kentucky, 21071, 38649, 30096, 18157, 70600, 10754, 4447, 6307
Franklin County, Kentucky, 21073, 49778, 47964, 23252, 137500, 13241, 9006, 4235
Fulton County, Kentucky, 21075, 6422, 28359, 3360, 61000, 1543, 600, 943
Gallatin County, Kentucky, 21077, 8567, 48370, 3829, 107500, 2130, 1418, 712
Garrard County, Kentucky, 21079, 16976, 44243, 7473, 128500, 5054, 3085, 1969
Grant County, Kentucky, 21081, 24670, 44824, 9956, 124900, 5864, 3734, 2130
Graves County, Kentucky, 21083, 37502, 39530, 16753, 92900, 10686, 5567, 5119
Grayson County, Kentucky, 21085, 26001, 35030, 13526, 95500, 7109, 3863, 3246
Green County, Kentucky, 21087, 11149, 34982, 5286, 74200, 3550, 1572, 1978
Greenup County, Kentucky, 21089, 36477, 45370, 16315, 97700, 10972, 5945, 5027
Hancock County, Kentucky, 21091, 8669, 50476, 3711, 104200, 2512, 1280, 1232
Hardin County, Kentucky, 21093, 107529, 50765, 45308, 143100, 25215, 17151, 8064
Harlan County, Kentucky, 21095, 28400, 25814, 13486, 52000, 7960, 3009, 4951
Harrison County, Kentucky, 21097, 18648, 35681, 8218, 113000, 4791, 2763, 2028
Hart County, Kentucky, 21099, 18441, 34774, 8710, 83600, 5273, 2715, 2558
Henderson County, Kentucky, 21101, 46396, 41036, 20421, 105500, 11863, 7298, 4565
Henry County, Kentucky, 21103, 15455, 46495, 6649, 121300, 4195, 2588, 1607
Hickman County, Kentucky, 21105, 4720, 41218, 2335, 68400, 1470, 592, 878
Hopkins County, Kentucky, 21107, 46518, 42346, 21257, 89500, 13324, 7199, 6125
Jackson County, Kentucky, 21109, 13357, 29826, 6520, 65900, 4239, 1743, 2496
Jefferson County, Kentucky, 21111, 755809, 48695, 340132, 150400, 189914, 127645, 62269
Jessamine County, Kentucky, 21113, 50328, 50558, 19796, 160400, 11676, 8255, 3421
Johnson County, Kentucky, 21115, 23350, 35570, 10555, 79200, 6766, 2925, 3841
Kenton County, Kentucky, 21117, 163007, 54296, 69369, 145200, 40956, 29842, 11114
Knott County, Kentucky, 21119, 16000, 30411, 7458, 57900, 4643, 1457, 3186
Knox County, Kentucky, 21121, 31809, 26599, 14471, 78400, 7802, 2965, 4837
Larue County, Kentucky, 21123, 14149, 38578, 6249, 110100, 3895, 2394, 1501
Laurel County, Kentucky, 21125, 59751, 36020, 25447, 94400, 16096, 8277, 7819
Lawrence County, Kentucky, 21127, 15821, 35935, 7272, 81400, 4706, 2056, 2650
Lee County, Kentucky, 21129, 7119, 22698, 3436, 67700, 2182, 857, 1325
Leslie County, Kentucky, 21131, 10997, 25872, 5257, 45500, 3199, 991, 2208
Letcher County, Kentucky, 21133, 23671, 30333, 11580, 56300, 7112, 2550, 4562
Lewis County, Kentucky, 21135, 13790, 28630, 6471, 67100, 4115, 1584, 2531
Lincoln County, Kentucky, 21137, 24498, 37139, 10849, 93600, 7189, 3807, 3382
Livingston County, Kentucky, 21139, 9394, 42171, 4830, 86900, 3031, 1583, 1448
Logan County, Kentucky, 21141, 26851, 38570, 12314, 94600, 7359, 3818, 3541
Lyon County, Kentucky, 21143, 8402, 46931, 4796, 141000, 2644, 1352, 1292
McCracken County, Kentucky, 21145, 65408, 44067, 31342, 124400, 18511, 10570, 7941
McCreary County, Kentucky, 21147, 18001, 19328, 7441, 62300, 4354, 1951, 2403
McLean County, Kentucky, 21149, 9500, 40770, 4250, 91700, 3027, 1535, 1492
Madison County, Kentucky, 21151, 85838, 42390, 35633, 144800, 18991, 11838, 7153
Magoffin County, Kentucky, 21153, 12979, 28500, 5932, 53100, 3628, 1245, 2383
Marion County, Kentucky, 21155, 19717, 38826, 8196, 98200, 5504, 2949, 2555
Marshall County, Kentucky, 21157, 31181, 45212, 15898, 111600, 9813, 5746, 4067
Martin County, Kentucky, 21159, 12631, 25795, 5150, 68200, 3086, 903, 2183
Mason County, Kentucky, 21161, 17296, 38824, 8128, 101100, 4510, 2461, 2049
Meade County, Kentucky, 21163, 29098, 49884, 12106, 126100, 7563, 4872, 2691
Menifee County, Kentucky, 21165, 6343, 31503, 3798, 78100, 1878, 802, 1076
Mercer County, Kentucky, 21167, 21342, 42083, 10038, 133600, 6296, 3567, 2729
Metcalfe County, Kentucky, 21169, 9985, 32294, 4676, 82600, 3039, 1449, 1590
Monroe County, Kentucky, 21171, 10765, 31045, 5208, 70600, 3232, 1475, 1757
Montgomery County, Kentucky, 21173, 27167, 39275, 11723, 114000, 6616, 3808, 2808
Morgan County, Kentucky, 21175, 13428, 29707, 5849, 75500, 3578, 1484, 2094
Muhlenberg County, Kentucky, 21177, 31309, 38961, 13665, 77800, 9173, 4641, 4532
Nelson County, Kentucky, 21179, 44564, 49298, 18443, 133600, 12796, 7725, 5071
Nicholas County, Kentucky, 21181, 7075, 36097, 3254, 83900, 2015, 1155, 860
Ohio County, Kentucky, 21183, 24065, 40189, 10228, 83700, 6863, 3376, 3487
Oldham County, Kentucky, 21185, 63037, 85452, 21089, 247500, 16912, 12607, 4305
Owen County, Kentucky, 21187, 10711, 41934, 5645, 98000, 3114, 1728, 1386
Owsley County, Kentucky, 21189, 4616, 20985, 2259, 69800, 1338, 595, 743
Pendleton County, Kentucky, 21191, 14514, 48353, 6323, 104800, 4150, 2548, 1602
Perry County, Kentucky, 21193, 28041, 32667, 12775, 71200, 7981, 3013, 4968
Pike County, Kentucky, 21195, 63434, 33183, 30309, 70400, 19063, 7510, 11553
Powell County, Kentucky, 21197, 12447, 29736, 5596, 76600, 3326, 1635, 1691
Pulaski County, Kentucky, 21199, 63635, 34790, 31267, 106800, 17669, 9723, 7946
Robertson County, Kentucky, 21201, 2208, 31741, 1103, 104000, 735, 301, 434
Rockcastle County, Kentucky, 21203, 16942, 31555, 7686, 73900, 5016, 2291, 2725
Rowan County, Kentucky, 21205, 23608, 36860, 10107, 115300, 5302, 3014, 2288
Russell County, Kentucky, 21207, 17669, 30720, 9942, 88000, 5177, 2406, 2771
Scott County, Kentucky, 21209, 50178, 63027, 20154, 164600, 13019, 9705, 3314
Shelby County, Kentucky, 21211, 44290, 60324, 16901, 175700, 10979, 7309, 3670
Simpson County, Kentucky, 21213, 17704, 39679, 7531, 116800, 4271, 2497, 1774
Spencer County, Kentucky, 21215, 17577, 63000, 6883, 176900, 5320, 3928, 1392
Taylor County, Kentucky, 21217, 24993, 33340, 10954, 93700, 6357, 3429, 2928
Todd County, Kentucky, 21219, 12524, 40497, 5292, 87300, 3287, 1531, 1756
Trigg County, Kentucky, 21221, 14250, 44083, 7835, 114100, 4946, 2653, 2293
Trimble County, Kentucky, 21223, 8783, 47409, 3923, 112000, 2686, 1588, 1098
Union County, Kentucky, 21225, 15138, 40120, 6183, 84100, 4015, 2283, 1732
Warren County, Kentucky, 21227, 118950, 44911, 49133, 141500, 26135, 17214, 8921
Washington County, Kentucky, 21229, 11910, 40976, 5077, 98100, 3529, 1928, 1601
Wayne County, Kentucky, 21231, 20655, 28573, 10860, 80300, 5592, 2497, 3095
Webster County, Kentucky, 21233, 13357, 38917, 5934, 74600, 3626, 1629, 1997
Whitley County, Kentucky, 21235, 35794, 31014, 15180, 77900, 8733, 4412, 4321
Wolfe County, Kentucky, 21237, 7261, 20504, 3652, 52700, 1934, 529, 1405
Woodford County, Kentucky, 21239, 25317, 58750, 10862, 181300, 6762, 4577, 2185
Acadia Parish, Louisiana, 22001, 62163, 37649, 25737, 91000, 15958, 6706, 9252
Allen Parish, Louisiana, 22003, 25653, 40948, 9781, 81100, 5983, 2639, 3344
Ascension Parish, Louisiana, 22005, 114738, 70551, 43255, 168600, 32259, 21144, 11115
Assumption Parish, Louisiana, 22007, 23057, 49167, 10470, 107300, 6950, 2803, 4147
Avoyelles Parish, Louisiana, 22009, 41389, 33739, 18157, 89500, 10443, 4692, 5751
Beauregard Parish, Louisiana, 22011, 36259, 45969, 15201, 104100, 10050, 4574, 5476
Bienville Parish, Louisiana, 22013, 13977, 32876, 7727, 69600, 4114, 1557, 2557
Bossier Parish, Louisiana, 22015, 123403, 52892, 52851, 154100, 30678, 19621, 11057
Caddo Parish, Louisiana, 22017, 254742, 41234, 112557, 128100, 60059, 33351, 26708
Calcasieu Parish, Louisiana, 22019, 195887, 45312, 84954, 124600, 51678, 26908, 24770
Caldwell Parish, Louisiana, 22021, 9990, 33294, 5014, 64400, 2870, 1207, 1663
Cameron Parish, Louisiana, 22023, 6706, 64231, 3524, 97400, 2369, 902, 1467
Catahoula Parish, Louisiana, 22025, 10247, 34904, 4901, 71100, 2793, 1068, 1725
Claiborne Parish, Louisiana, 22027, 16639, 32072, 7760, 73700, 4082, 1546, 2536
Concordia Parish, Louisiana, 22029, 20449, 29654, 9418, 77400, 4711, 1942, 2769
De Soto Parish, Louisiana, 22031, 26965, 41468, 12369, 98400, 7566, 3927, 3639
East Baton Rouge Parish, Louisiana, 22033, 444690, 49285, 190343, 170500, 100963, 65195, 35768
East Carroll Parish, Louisiana, 22035, 7501, 21099, 3156, 49300, 1278, 469, 809
East Feliciana Parish, Louisiana, 22037, 19855, 45520, 8138, 127100, 5660, 2557, 3103
Evangeline Parish, Louisiana, 22039, 33768, 30009, 14815, 83900, 7895, 3309, 4586
Franklin Parish, Louisiana, 22041, 20550, 30275, 9091, 79300, 5258, 1857, 3401
Grant Parish, Louisiana, 22043, 22362, 39914, 8982, 83200, 5323, 2285, 3038
Iberia Parish, Louisiana, 22045, 73938, 45261, 30002, 99600, 18573, 8513, 10060
Iberville Parish, Louisiana, 22047, 33229, 45117, 12914, 112700, 8354, 3712, 4642
Jackson Parish, Louisiana, 22049, 16109, 38029, 7729, 77200, 4110, 1776, 2334
Jefferson Parish, Louisiana, 22051, 435092, 47947, 189163, 172700, 103991, 60975, 43016
Jefferson Davis Parish, Louisiana, 22053, 31434, 39063, 13519, 91900, 8622, 3854, 4768
Lafayette Parish, Louisiana, 22055, 231811, 51869, 96468, 166700, 57277, 34383, 22894
Lafourche Parish, Louisiana, 22057, 97474, 51030, 39418, 133200, 26975, 12869, 14106
LaSalle Parish, Louisiana, 22059, 14899, 37310, 6581, 70300, 4347, 1797, 2550
Lincoln Parish, Louisiana, 22061, 47349, 33467, 19645, 126100, 9232, 4636, 4596
Livingston Parish, Louisiana, 22063, 133949, 58251, 52888, 152600, 38124, 23550, 14574
Madison Parish, Louisiana, 22065, 11873, 23854, 4884, 61700, 2146, 755, 1391
Morehouse Parish, Louisiana, 22067, 27012, 28003, 12494, 80600, 6852, 2629, 4223
Natchitoches Parish, Louisiana, 22069, 39330, 31345, 18720, 101900, 8391, 3742, 4649
Orleans Parish, Louisiana, 22071, 376738, 36792, 191951, 192400, 70843, 39115, 31728
Ouachita Parish, Louisiana, 22073, 155769, 37754, 65803, 123300, 34429, 19421, 15008
Plaquemines Parish, Louisiana, 22075, 23599, 50314, 9813, 155300, 5941, 2699, 3242
Pointe Coupee Parish, Louisiana, 22077, 22498, 43825, 11257, 115800, 6713, 2916, 3797
Rapides Parish, Louisiana, 22079, 132225, 40734, 56740, 125800, 30052, 15949, 14103
Red River Parish, Louisiana, 22081, 8838, 38000, 4132, 83000, 2569, 1024, 1545
Richland Parish, Louisiana, 22083, 20777, 36421, 8786, 82500, 5055, 2240, 2815
Sabine Parish, Louisiana, 22085, 24248, 38828, 14344, 79900, 7049, 2628, 4421
St. Bernard Parish, Louisiana, 22087, 42858, 42753, 16800, 130000, 9810, 5125, 4685
St. Charles Parish, Louisiana, 22089, 52639, 59990, 20209, 184300, 14886, 8939, 5947
St. Helena Parish, Louisiana, 22091, 10818, 35437, 5163, 78400, 3516, 1292, 2224
St. James Parish, Louisiana, 22093, 21650, 51107, 8650, 129200, 6289, 3050, 3239
St. John the Baptist Parish, Louisiana, 22095, 44161, 50921, 17584, 150000, 11682, 7100, 4582
St. Landry Parish, Louisiana, 22097, 83613, 32625, 36047, 90800, 21374, 9050, 12324
St. Martin Parish, Louisiana, 22099, 53126, 42794, 22390, 101700, 14952, 7093, 7859
St. Mary Parish, Louisiana, 22101, 53441, 40781, 23162, 92900, 13607, 5311, 8296
St. Tammany Parish, Louisiana, 22103, 242960, 62137, 97891, 197100, 68611, 44868, 23743
Tangipahoa Parish, Louisiana, 22105, 125486, 41302, 51938, 137500, 30751, 17100, 13651
Tensas Parish, Louisiana, 22107, 4893, 22940, 3367, 54200, 1166, 329, 837
Terrebonne Parish, Louisiana, 22109, 112742, 47826, 44363, 137000, 28736, 13999, 14737
Union Parish, Louisiana, 22111, 22533, 34992, 11420, 88000, 6826, 2764, 4062
Vermilion Parish, Louisiana, 22113, 59110, 45374, 25722, 98100, 16398, 7026, 9372
Vernon Parish, Louisiana, 22115, 52476, 46312, 21649, 98000, 9547, 4452, 5095
Washington Parish, Louisiana, 22117, 46556, 30705, 21232, 79600, 12740, 5416, 7324
Webster Parish, Louisiana, 22119, 40617, 33681, 19421, 81800, 11176, 4934, 6242
West Baton Rouge Parish, Louisiana, 22121, 24669, 53703, 9873, 162500, 6471, 3756, 2715
West Carroll Parish, Louisiana, 22123, 11454, 31926, 5065, 66800, 2961, 1033, 1928
West Feliciana Parish, Louisiana, 22125, 15415, 56685, 5214, 188200, 2974, 1602, 1372
Winn Parish, Louisiana, 22127, 14855, 31087, 7243, 73100, 3651, 1370, 2281
Androscoggin County, Maine, 23001, 107393, 47537, 49164, 151100, 28372, 18875, 9497
Aroostook County, Maine, 23003, 70005, 36923, 39477, 94800, 21450, 11565, 9885
Cumberland County, Maine, 23005, 286119, 60051, 139772, 243800, 79075, 55371, 23704
Franklin County, Maine, 23007, 30402, 42811, 21886, 129600, 9456, 5208, 4248
Hancock County, Maine, 23009, 54658, 47030, 40413, 198300, 17788, 9868, 7920
Kennebec County, Maine, 23011, 121112, 46917, 61383, 150600, 36158, 22810, 13348
Knox County, Maine, 23013, 39723, 50693, 23889, 197000, 12995, 7865, 5130
Lincoln County, Maine, 23015, 34156, 50462, 23602, 204100, 11822, 7031, 4791
Oxford County, Maine, 23017, 57421, 40630, 36264, 135500, 17225, 10151, 7074
Penobscot County, Maine, 23019, 153437, 44271, 74196, 137400, 41889, 26419, 15470
Piscataquis County, Maine, 23021, 17156, 37495, 15390, 109700, 5618, 2944, 2674
Sagadahoc County, Maine, 23023, 35092, 53298, 18417, 189300, 11625, 7583, 4042
Somerset County, Maine, 23025, 51577, 40066, 30720, 107300, 16701, 9324, 7377
Waldo County, Maine, 23027, 38976, 44082, 21717, 157800, 13094, 7235, 5859
Washington County, Maine, 23029, 32191, 38083, 23013, 106900, 10638, 4990, 5648
York County, Maine, 23031, 199682, 57919, 106924, 229600, 60089, 41992, 18097
Allegany County, Maryland, 24001, 73549, 40551, 33262, 120800, 19481, 10760, 8721
Anne Arundel County, Maryland, 24003, 555280, 89860, 217545, 334100, 150384, 115325, 35059
Baltimore County, Maryland, 24005, 822959, 67095, 336682, 246600, 207389, 144589, 62800
Calvert County, Maryland, 24009, 90114, 95828, 34384, 341800, 25432, 20805, 4627
Caroline County, Maryland, 24011, 32661, 52465, 13525, 193300, 8402, 5705, 2697
Carroll County, Maryland, 24013, 167444, 85385, 62919, 321300, 49208, 37037, 12171
Cecil County, Maryland, 24015, 101960, 66396, 42030, 242900, 27019, 18767, 8252
Charles County, Maryland, 24017, 152754, 90607, 57156, 284500, 41321, 34457, 6864
Dorchester County, Maryland, 24019, 32534, 47093, 16688, 187700, 8698, 5268, 3430
Frederick County, Maryland, 24021, 241373, 83700, 92708, 300100, 65427, 51201, 14226
Garrett County, Maryland, 24023, 29813, 45432, 19022, 165300, 8848, 4762, 4086
Harford County, Maryland, 24025, 248966, 80465, 97572, 278500, 72081, 53018, 19063
Howard County, Maryland, 24027, 304115, 110238, 113490, 429100, 79666, 63344, 16322
Kent County, Maryland, 24029, 19923, 58147, 10644, 247200, 5478, 3369, 2109
Montgomery County, Maryland, 24031, 1017859, 99435, 382913, 454700, 241654, 184677, 56977
Prince George's County, Maryland, 24033, 892816, 74260, 329897, 254700, 189462, 158208, 31254
Queen Anne's County, Maryland, 24035, 48600, 85963, 20577, 339900, 14682, 10495, 4187
St. Mary's County, Maryland, 24037, 109614, 86987, 42762, 297200, 27650, 20452, 7198
Somerset County, Maryland, 24039, 25980, 35154, 11181, 149600, 5430, 2986, 2444
Talbot County, Maryland, 24041, 37799, 58228, 20027, 319500, 11131, 7024, 4107
Washington County, Maryland, 24043, 149270, 56228, 61111, 200100, 35980, 24375, 11605
Wicomico County, Maryland, 24045, 101182, 52278, 41685, 172400, 23060, 15686, 7374
Worcester County, Maryland, 24047, 51519, 56773, 55749, 243100, 15634, 9610, 6024
Baltimore city, Maryland, 24510, 622454, 42241, 296727, 152400, 114145, 79560, 34585
Barnstable County, Massachusetts, 25001, 214766, 63251, 161311, 363500, 74410, 47444, 26966
Berkshire County, Massachusetts, 25003, 129288, 49956, 68385, 204700, 37899, 24198, 13701
Bristol County, Massachusetts, 25005, 552763, 56842, 230986, 273100, 131608, 91901, 39707
Dukes County, Massachusetts, 25007, 17048, 64222, 17446, 660800, 4802, 2946, 1856
Essex County, Massachusetts, 25009, 763849, 69068, 307894, 353100, 181293, 130543, 50750
Franklin County, Massachusetts, 25011, 71144, 55221, 33646, 220800, 20834, 13431, 7403
Hampden County, Massachusetts, 25013, 468041, 50461, 192100, 196400, 109087, 74143, 34944
Hampshire County, Massachusetts, 25015, 160759, 61368, 62860, 265400, 38603, 25464, 13139
Middlesex County, Massachusetts, 25017, 1556116, 85118, 617089, 414600, 365501, 257747, 107754
Nantucket County, Massachusetts, 25019, 10556, 84057, 11763, 902500, 2568, 1793, 775
Norfolk County, Massachusetts, 25021, 687721, 88262, 272397, 399500, 178492, 128876, 49616
Plymouth County, Massachusetts, 25023, 503681, 75459, 201930, 328600, 137942, 100975, 36967
Suffolk County, Massachusetts, 25025, 758919, 55044, 321386, 377100, 105671, 79360, 26311
Worcester County, Massachusetts, 25027, 810935, 65313, 328627, 252600, 194957, 141342, 53615
Alcona County, Michigan, 26001, 10550, 38033, 11056, 97500, 4454, 2183, 2271
Alger County, Michigan, 26003, 9476, 39300, 6581, 116400, 2977, 1421, 1556
Allegan County, Michigan, 26005, 112837, 54264, 49692, 140400, 33872, 20511, 13361
Alpena County, Michigan, 26007, 29068, 38829, 15983, 93300, 9693, 5430, 4263
Antrim County, Michigan, 26009, 23267, 46845, 17811, 140700, 8096, 4754, 3342
Arenac County, Michigan, 26011, 15424, 38307, 9767, 87500, 5352, 2642, 2710
Baraga County, Michigan, 26013, 8690, 39803, 5235, 88100, 2498, 1043, 1455
Barry County, Michigan, 26015, 59147, 55064, 27044, 134700, 18714, 12150, 6564
Bay County, Michigan, 26017, 106698, 45583, 48057, 92800, 33866, 18142, 15724
Benzie County, Michigan, 26019, 17437, 47388, 12267, 150000, 6166, 3644, 2522
Berrien County, Michigan, 26021, 155565, 44993, 76772, 132600, 43365, 26842, 16523
Branch County, Michigan, 26023, 43706, 44373, 20672, 95200, 12234, 7221, 5013
Calhoun County, Michigan, 26025, 134790, 42520, 60716, 96000, 36640, 21821, 14819
Cass County, Michigan, 26027, 51952, 46570, 25909, 122800, 16605, 10003, 6602
Charlevoix County, Michigan, 26029, 26134, 46554, 17336, 153000, 8689, 5074, 3615
Cheboygan County, Michigan, 26031, 25690, 40219, 18284, 112400, 9131, 5010, 4121
Chippewa County, Michigan, 26033, 38586, 41993, 21231, 106300, 9833, 5360, 4473
Clare County, Michigan, 26035, 30710, 33015, 23153, 79800, 10679, 5867, 4812
Clinton County, Michigan, 26037, 76905, 60909, 30897, 154400, 23109, 14930, 8179
Crawford County, Michigan, 26039, 13895, 41743, 11107, 96800, 4803, 2690, 2113
Delta County, Michigan, 26041, 36712, 42031, 20200, 101900, 12321, 6757, 5564
Dickinson County, Michigan, 26043, 26012, 43779, 14008, 86300, 8977, 4313, 4664
Eaton County, Michigan, 26045, 108341, 54993, 47092, 134500, 31079, 20991, 10088
Emmet County, Michigan, 26047, 33018, 51018, 21319, 163100, 10534, 6483, 4051
Genesee County, Michigan, 26049, 415874, 42327, 191178, 88500, 114823, 69856, 44967
Gladwin County, Michigan, 26051, 25501, 38021, 17642, 98100, 9134, 4826, 4308
Gogebic County, Michigan, 26053, 15824, 35686, 10749, 68800, 5247, 2447, 2800
Grand Traverse County, Michigan, 26055, 89907, 52950, 42126, 167900, 26750, 17868, 8882
Gratiot County, Michigan, 26057, 41878, 41912, 16258, 88900, 10852, 5894, 4958
Hillsdale County, Michigan, 26059, 46178, 41961, 21667, 98700, 13759, 8110, 5649
Houghton County, Michigan, 26061, 36660, 37776, 18603, 93800, 9373, 5098, 4275
Huron County, Michigan, 26063, 32290, 42161, 21171, 92900, 11253, 5191, 6062
Ingham County, Michigan, 26065, 283491, 45679, 121722, 117400, 63828, 43449, 20379
Ionia County, Michigan, 26067, 64064, 49124, 24634, 110000, 17337, 10996, 6341
Iosco County, Michigan, 26069, 25401, 37317, 20391, 85400, 9091, 4710, 4381
Iron County, Michigan, 26071, 11507, 33663, 9256, 74400, 4515, 1967, 2548
Isabella County, Michigan, 26073, 70669, 39377, 28482, 122500, 14838, 9004, 5834
Jackson County, Michigan, 26075, 159759, 46326, 69121, 111500, 43555, 27481, 16074
Kalamazoo County, Michigan, 26077, 256752, 47476, 110196, 137100, 64302, 42414, 21888
Kalkaska County, Michigan, 26079, 17230, 40534, 12130, 98300, 5791, 3443, 2348
Kent County, Michigan, 26081, 622590, 53063, 248224, 139300, 160040, 107037, 53003
Keweenaw County, Michigan, 26083, 2198, 37813, 2473, 102000, 922, 412, 510
Lake County, Michigan, 26085, 11426, 30439, 14927, 79500, 3606, 1713, 1893
Lapeer County, Michigan, 26087, 88235, 52996, 36238, 132300, 27156, 18325, 8831
Leelanau County, Michigan, 26089, 21772, 56189, 15141, 241900, 7836, 4773, 3063
Lenawee County, Michigan, 26091, 98902, 48043, 43412, 114900, 29180, 19171, 10009
Livingston County, Michigan, 26093, 184591, 75204, 74169, 192500, 58358, 43049, 15309
Luce County, Michigan, 26095, 6477, 37088, 4336, 74200, 1795, 788, 1007
Mackinac County, Michigan, 26097, 11044, 38434, 11021, 121300, 3839, 1960, 1879
Macomb County, Michigan, 26099, 854689, 54582, 359902, 126000, 246518, 160781, 85737
Manistee County, Michigan, 26101, 24536, 41395, 15680, 107100, 8192, 4203, 3989
Marquette County, Michigan, 26103, 67582, 45409, 34480, 131400, 18161, 10571, 7590
Mason County, Michigan, 26105, 28711, 42024, 17278, 119900, 9192, 5282, 3910
Mecosta County, Michigan, 26107, 43301, 41889, 21092, 110500, 11532, 6335, 5197
Menominee County, Michigan, 26109, 23717, 40373, 14178, 93400, 8390, 4456, 3934
Midland County, Michigan, 26111, 83624, 54059, 36195, 131200, 25337, 15591, 9746
Missaukee County, Michigan, 26113, 14988, 41098, 9085, 103200, 4810, 2668, 2142
Monroe County, Michigan, 26115, 150436, 55653, 63403, 137200, 46537, 30349, 16188
Montcalm County, Michigan, 26117, 63004, 41584, 28127, 94100, 18408, 11312, 7096
Montmorency County, Michigan, 26119, 9401, 36250, 9554, 91200, 3481, 1863, 1618
Muskegon County, Michigan, 26121, 171483, 42829, 73354, 99000, 48321, 28835, 19486
Newaygo County, Michigan, 26123, 48029, 43693, 24972, 101500, 15249, 8575, 6674
Oakland County, Michigan, 26125, 1229503, 67465, 531609, 178900, 347701, 243137, 104564
Oceana County, Michigan, 26127, 26229, 41617, 15927, 104200, 7913, 4196, 3717
Ogemaw County, Michigan, 26129, 21222, 36063, 16023, 86900, 7689, 4149, 3540
Ontonagon County, Michigan, 26131, 6298, 34459, 5652, 68900, 2709, 1139, 1570
Osceola County, Michigan, 26133, 23234, 38999, 13552, 90300, 6902, 3601, 3301
Oscoda County, Michigan, 26135, 8444, 33021, 9106, 80600, 3117, 1575, 1542
Otsego County, Michigan, 26137, 24141, 48917, 14758, 121700, 7877, 4997, 2880
Ottawa County, Michigan, 26139, 273136, 58989, 103847, 155400, 74233, 48913, 25320
Presque Isle County, Michigan, 26141, 13037, 41213, 10414, 92900, 5237, 2586, 2651
Roscommon County, Michigan, 26143, 24068, 35133, 24374, 91400, 9503, 5108, 4395
Saginaw County, Michigan, 26145, 196479, 43042, 86823, 92900, 56270, 31941, 24329
St. Clair County, Michigan, 26147, 160429, 49730, 71889, 120800, 48783, 31080, 17703
St. Joseph County, Michigan, 26149, 61022, 44449, 27682, 105900, 17458, 10393, 7065
Sanilac County, Michigan, 26151, 42014, 41100, 22598, 94800, 13009, 6761, 6248
Schoolcraft County, Michigan, 26153, 8288, 34118, 6325, 89000, 2739, 1296, 1443
Shiawassee County, Michigan, 26155, 69113, 48233, 30129, 105100, 20857, 12987, 7870
Tuscola County, Michigan, 26157, 54420, 43768, 24303, 93700, 17347, 9585, 7762
Van Buren County, Michigan, 26159, 75351, 46008, 36690, 118700, 21955, 13079, 8876
Washtenaw County, Michigan, 26161, 354092, 61003, 149098, 208200, 82525, 57915, 24610
Wayne County, Michigan, 26163, 1778969, 41210, 817593, 83000, 420277, 241376, 178901
Wexford County, Michigan, 26165, 32751, 41534, 16690, 91800, 9719, 5816, 3903
Aitkin County, Minnesota, 27001, 15839, 42252, 16112, 166400, 6270, 3192, 3078
Anoka County, Minnesota, 27003, 338764, 70873, 128780, 187600, 99522, 75181, 24341
Becker County, Minnesota, 27005, 33138, 52038, 19060, 175000, 10733, 6162, 4571
Beltrami County, Minnesota, 27007, 45434, 44757, 20725, 148800, 11561, 6605, 4956
Benton County, Minnesota, 27009, 39221, 52178, 16375, 156100, 10983, 7575, 3408
Big Stone County, Minnesota, 27011, 5134, 47794, 3109, 94900, 1803, 902, 901
Blue Earth County, Minnesota, 27013, 65125, 50061, 26843, 161500, 16052, 10259, 5793
Brown County, Minnesota, 27015, 25391, 52598, 11543, 125500, 8302, 4565, 3737
Carlton County, Minnesota, 27017, 35443, 53227, 15759, 156900, 10540, 6892, 3648
Carver County, Minnesota, 27019, 95715, 86323, 35842, 267000, 27654, 21411, 6243
Cass County, Minnesota, 27021, 28519, 46531, 25011, 172000, 10384, 5805, 4579
Chippewa County, Minnesota, 27023, 12154, 50858, 5715, 100600, 3542, 1902, 1640
Chisago County, Minnesota, 27025, 53834, 71001, 21293, 192300, 16828, 12467, 4361
Clay County, Minnesota, 27027, 60879, 57965, 24688, 159500, 15916, 11015, 4901
Clearwater County, Minnesota, 27029, 8752, 43421, 4756, 116200, 2735, 1479, 1256
Cook County, Minnesota, 27031, 5194, 52299, 5671, 242400, 1955, 938, 1017
Cottonwood County, Minnesota, 27033, 11632, 46750, 5386, 87200, 3759, 1842, 1917
Crow Wing County, Minnesota, 27035, 63048, 49435, 40658, 178400, 19847, 12445, 7402
Dakota County, Minnesota, 27037, 408456, 75567, 162066, 220400, 116951, 89246, 27705
Dodge County, Minnesota, 27039, 20290, 68116, 8015, 158700, 6261, 4264, 1997
Douglas County, Minnesota, 27041, 36620, 54531, 20396, 188400, 11872, 7421, 4451
Faribault County, Minnesota, 27043, 14230, 47540, 7055, 85600, 4897, 2495, 2402
Fillmore County, Minnesota, 27045, 20843, 51665, 9813, 140100, 6682, 3878, 2804
Freeborn County, Minnesota, 27047, 30897, 47105, 14192, 104800, 9925, 5483, 4442
Goodhue County, Minnesota, 27049, 46377, 57062, 20351, 179200, 14246, 9014, 5232
Grant County, Minnesota, 27051, 5961, 50174, 3298, 101500, 2031, 1142, 889
Hennepin County, Minnesota, 27053, 1197776, 65834, 518332, 229200, 307395, 223845, 83550
Houston County, Minnesota, 27055, 18812, 53809, 8625, 159000, 6365, 3449, 2916
Hubbard County, Minnesota, 27057, 20574, 47486, 14628, 174300, 7149, 4145, 3004
Isanti County, Minnesota, 27059, 38296, 59865, 15408, 164900, 11368, 8249, 3119
Itasca County, Minnesota, 27061, 45354, 47761, 27144, 155500, 15076, 8515, 6561
Jackson County, Minnesota, 27063, 10211, 50574, 5005, 104100, 3330, 1567, 1763
Kanabec County, Minnesota, 27065, 16003, 47384, 7794, 137300, 4974, 3117, 1857
Kandiyohi County, Minnesota, 27067, 42444, 52632, 19569, 160800, 12125, 7512, 4613
Kittson County, Minnesota, 27069, 4480, 52326, 2604, 72600, 1545, 590, 955
Koochiching County, Minnesota, 27071, 13054, 42919, 7877, 101400, 4572, 2414, 2158
Lac qui Parle County, Minnesota, 27073, 7023, 49903, 3672, 83000, 2481, 1054, 1427
Lake County, Minnesota, 27075, 10750, 48417, 7715, 157700, 4062, 2181, 1881
Lake of the Woods County, Minnesota, 27077, 3949, 42263, 3671, 117000, 1387, 798, 589
Le Sueur County, Minnesota, 27079, 27707, 60632, 12468, 176500, 8833, 5681, 3152
Lincoln County, Minnesota, 27081, 5808, 49575, 3126, 92500, 1980, 929, 1051
Lyon County, Minnesota, 27083, 25699, 51600, 11117, 133700, 6746, 3875, 2871
McLeod County, Minnesota, 27085, 36046, 56128, 15746, 148300, 11299, 7363, 3936
Mahnomen County, Minnesota, 27087, 5496, 41118, 2782, 97300, 1468, 653, 815
Marshall County, Minnesota, 27089, 9453, 54092, 4804, 93500, 3252, 1569, 1683
Martin County, Minnesota, 27091, 20350, 51391, 9970, 105400, 6513, 3584, 2929
Meeker County, Minnesota, 27093, 23129, 55042, 10688, 157200, 7350, 4512, 2838
Mille Lacs County, Minnesota, 27095, 25809, 49094, 12718, 140900, 7405, 4866, 2539
Morrison County, Minnesota, 27097, 32962, 50049, 15811, 153300, 10636, 6273, 4363
Mower County, Minnesota, 27099, 39227, 49427, 16991, 111700, 11095, 6446, 4649
Murray County, Minnesota, 27101, 8529, 51983, 4578, 98600, 3038, 1392, 1646
Nicollet County, Minnesota, 27103, 33086, 58640, 13131, 170400, 9214, 6125, 3089
Nobles County, Minnesota, 27105, 21687, 50625, 8569, 106900, 5656, 2831, 2825
Norman County, Minnesota, 27107, 6692, 50377, 3409, 83200, 2201, 987, 1214
Olmsted County, Minnesota, 27109, 148736, 68023, 61433, 173000, 42696, 29638, 13058
Otter Tail County, Minnesota, 27111, 57511, 52365, 35615, 164900, 18873, 10978, 7895
Pennington County, Minnesota, 27113, 14110, 47127, 6331, 115200, 4378, 2504, 1874
Pine County, Minnesota, 27115, 29218, 44549, 17228, 141200, 8875, 5469, 3406
Pipestone County, Minnesota, 27117, 9354, 46990, 4458, 92300, 2960, 1427, 1533
Polk County, Minnesota, 27119, 31547, 53326, 14693, 136700, 9213, 4863, 4350
Pope County, Minnesota, 27121, 10948, 52785, 6495, 150900, 3853, 2230, 1623
Ramsey County, Minnesota, 27123, 527411, 56104, 218024, 193700, 122117, 83962, 38155
Red Lake County, Minnesota, 27125, 4061, 50332, 1946, 97800, 1369, 618, 751
Redwood County, Minnesota, 27127, 15723, 47211, 7249, 92600, 4952, 2275, 2677
Renville County, Minnesota, 27129, 15171, 52149, 7330, 95700, 5044, 2376, 2668
Rice County, Minnesota, 27131, 64886, 59598, 24531, 185200, 16655, 11488, 5167
Rock County, Minnesota, 27133, 9563, 51496, 4267, 128300, 2957, 1635, 1322
Roseau County, Minnesota, 27135, 15615, 53199, 7426, 113200, 4967, 2655, 2312
St. Louis County, Minnesota, 27137, 200506, 48331, 103195, 139900, 60095, 35462, 24633
Scott County, Minnesota, 27139, 137322, 87794, 48760, 247600, 38909, 30728, 8181
Sherburne County, Minnesota, 27141, 90401, 74170, 32743, 190600, 24721, 19816, 4905
Sibley County, Minnesota, 27143, 15021, 56990, 6538, 131300, 4732, 2735, 1997
Stearns County, Minnesota, 27145, 152595, 56336, 62632, 166400, 40063, 25740, 14323
Steele County, Minnesota, 27147, 36523, 57858, 15395, 150500, 10896, 7079, 3817
Stevens County, Minnesota, 27149, 9771, 52302, 4156, 131500, 2465, 1364, 1101
Swift County, Minnesota, 27151, 9525, 49035, 4815, 92400, 3105, 1515, 1590
Todd County, Minnesota, 27153, 24466, 46414, 12913, 131400, 8032, 4399, 3633
Traverse County, Minnesota, 27155, 3429, 49186, 2075, 70900, 1230, 474, 756
Wabasha County, Minnesota, 27157, 21381, 56510, 10029, 159500, 7285, 4362, 2923
Wadena County, Minnesota, 27159, 13759, 41906, 6942, 114300, 4362, 2340, 2022
Waseca County, Minnesota, 27161, 19076, 53564, 7895, 141800, 5669, 3273, 2396
Washington County, Minnesota, 27163, 246670, 83706, 94934, 243600, 72864, 54364, 18500
Watonwan County, Minnesota, 27165, 11054, 50604, 5033, 93400, 3308, 1896, 1412
Wilkin County, Minnesota, 27167, 6526, 51476, 3069, 114800, 2096, 1116, 980
Winona County, Minnesota, 27169, 51213, 50547, 20886, 153900, 13325, 8245, 5080
Wright County, Minnesota, 27171, 128691, 73557, 49630, 193100, 37478, 28184, 9294
Yellow Medicine County, Minnesota, 27173, 10092, 53041, 4754, 96800, 3308, 1709, 1599
Adams County, Mississippi, 28001, 31979, 28869, 14622, 85600, 7731, 3382, 4349
Alcorn County, Mississippi, 28003, 37319, 36163, 17100, 84800, 10175, 4803, 5372
Amite County, Mississippi, 28005, 12840, 30704, 6636, 71600, 4201, 1231, 2970
Attala County, Mississippi, 28007, 19175, 32886, 9130, 73600, 5378, 2214, 3164
Benton County, Mississippi, 28009, 8470, 33141, 4197, 72800, 2589, 1142, 1447
Bolivar County, Mississippi, 28011, 33803, 27585, 14215, 85100, 6920, 2884, 4036
Calhoun County, Mississippi, 28013, 14789, 31098, 6917, 61300, 4286, 1642, 2644
Carroll County, Mississippi, 28015, 10338, 37289, 5059, 80800, 3110, 1346, 1764
Chickasaw County, Mississippi, 28017, 17391, 30926, 7520, 63400, 4772, 2074, 2698
Choctaw County, Mississippi, 28019, 8354, 30692, 4161, 70300, 2374, 1056, 1318
Claiborne County, Mississippi, 28021, 9330, 23259, 4217, 53800, 2230, 706, 1524
Clarke County, Mississippi, 28023, 16362, 35993, 7885, 65300, 5334, 1979, 3355
Clay County, Mississippi, 28025, 20279, 31669, 9188, 80900, 5433, 2645, 2788
Coahoma County, Mississippi, 28027, 25254, 28851, 10747, 61900, 4884, 2283, 2601
Copiah County, Mississippi, 28029, 28921, 35130, 12130, 84500, 7610, 3096, 4514
Covington County, Mississippi, 28031, 19471, 31631, 8502, 71800, 5607, 2220, 3387
DeSoto County, Mississippi, 28033, 168586, 58278, 63321, 152700, 44036, 31793, 12243
Forrest County, Mississippi, 28035, 76267, 36416, 32481, 110600, 15335, 8083, 7252
Franklin County, Mississippi, 28037, 7857, 38170, 4157, 73200, 2487, 951, 1536
George County, Mississippi, 28039, 23104, 44258, 9355, 101300, 6384, 3020, 3364
Greene County, Mississippi, 28041, 14129, 40176, 5125, 86200, 3385, 1300, 2085
Grenada County, Mississippi, 28043, 21591, 31779, 10169, 92600, 5456, 3245, 2211
Hancock County, Mississippi, 28045, 45627, 43355, 23196, 133000, 13270, 6471, 6799
Harrison County, Mississippi, 28047, 196268, 41722, 88821, 137700, 43380, 25400, 17980
Hinds County, Mississippi, 28049, 245874, 37324, 104012, 107100, 52712, 32872, 19840
Holmes County, Mississippi, 28051, 18772, 20732, 8419, 51500, 4072, 1476, 2596
Humphreys County, Mississippi, 28053, 8984, 23216, 3835, 60500, 1656, 712, 944
Issaquena County, Mississippi, 28055, 1291, 23491, 545, 57000, 246, 72, 174
Itawamba County, Mississippi, 28057, 23451, 35004, 10155, 83700, 6877, 2683, 4194
Jackson County, Mississippi, 28059, 140676, 48406, 60889, 121200, 35474, 20045, 15429
Jasper County, Mississippi, 28061, 16588, 31578, 8220, 69900, 5634, 2379, 3255
Jefferson County, Mississippi, 28063, 7586, 20743, 3677, 60500, 1548, 506, 1042
Jefferson Davis County, Mississippi, 28065, 11941, 26279, 5872, 82300, 3835, 1638, 2197
Jones County, Mississippi, 28067, 68276, 37143, 28564, 87500, 18021, 8183, 9838
Kemper County, Mississippi, 28069, 10211, 30056, 4729, 66000, 2797, 975, 1822
Lafayette County, Mississippi, 28071, 51169, 44643, 23524, 159200, 10351, 6243, 4108
Lamar County, Mississippi, 28073, 58885, 52035, 24202, 168100, 14549, 9011, 5538
Lauderdale County, Mississippi, 28075, 79832, 38132, 34885, 87600, 19372, 9158, 10214
Lawrence County, Mississippi, 28077, 12586, 35634, 6027, 86800, 3739, 1665, 2074
Leake County, Mississippi, 28079, 23153, 33452, 9416, 76000, 6102, 2670, 3432
Lee County, Mississippi, 28081, 85036, 42784, 36151, 117000, 22066, 13587, 8479
Leflore County, Mississippi, 28083, 31516, 24233, 13168, 70000, 5570, 2669, 2901
Lincoln County, Mississippi, 28085, 34765, 36473, 15271, 85300, 9699, 4047, 5652
Lowndes County, Mississippi, 28087, 59699, 40239, 26895, 115700, 14310, 7807, 6503
Madison County, Mississippi, 28089, 100202, 64376, 40400, 206200, 26682, 17056, 9626
Marion County, Mississippi, 28091, 26109, 30668, 11845, 78400, 7488, 3267, 4221
Marshall County, Mississippi, 28093, 36385, 37419, 14997, 84800, 10266, 5486, 4780
Monroe County, Mississippi, 28095, 36175, 36783, 16449, 79100, 10408, 4706, 5702
Montgomery County, Mississippi, 28097, 10464, 30146, 5355, 75200, 3245, 1312, 1933
Neshoba County, Mississippi, 28099, 29553, 35645, 12367, 77800, 7709, 3277, 4432
Newton County, Mississippi, 28101, 21663, 37045, 9373, 76600, 6181, 2804, 3377
Noxubee County, Mississippi, 28103, 11143, 26677, 5166, 61300, 2926, 1269, 1657
Oktibbeha County, Mississippi, 28105, 49048, 32485, 21217, 142100, 9220, 4940, 4280
Panola County, Mississippi, 28107, 34373, 36555, 14726, 77900, 9003, 4485, 4518
Pearl River County, Mississippi, 28109, 55196, 40976, 24423, 114100, 15710, 7468, 8242
Perry County, Mississippi, 28111, 12187, 34045, 5520, 78000, 3766, 1364, 2402
Pike County, Mississippi, 28113, 40075, 31677, 17898, 83300, 9795, 4275, 5520
Pontotoc County, Mississippi, 28115, 30517, 40645, 12501, 81500, 8088, 4151, 3937
Prentiss County, Mississippi, 28117, 25380, 32945, 11073, 78100, 7125, 3241, 3884
Quitman County, Mississippi, 28119, 7761, 24583, 3588, 54100, 1998, 739, 1259
Rankin County, Mississippi, 28121, 146761, 58801, 57764, 153300, 39926, 26018, 13908
Scott County, Mississippi, 28123, 28293, 32935, 11480, 68000, 7196, 3046, 4150
Sharkey County, Mississippi, 28125, 4805, 30525, 2120, 62000, 1068, 395, 673
Simpson County, Mississippi, 28127, 27401, 35375, 11923, 78800, 7546, 3066, 4480
Smith County, Mississippi, 28129, 16257, 32951, 7239, 79700, 4908, 1784, 3124
Stone County, Mississippi, 28131, 17978, 45025, 7216, 111800, 4579, 2020, 2559
Sunflower County, Mississippi, 28133, 27911, 27384, 9702, 70000, 4904, 2506, 2398
Tallahatchie County, Mississippi, 28135, 14959, 29731, 5530, 58100, 3283, 1525, 1758
Tate County, Mississippi, 28137, 28415, 42880, 11100, 110200, 7389, 4298, 3091
Tippah County, Mississippi, 28139, 22054, 35609, 9723, 77800, 6414, 2862, 3552
Tishomingo County, Mississippi, 28141, 19539, 35143, 10303, 76600, 5861, 2574, 3287
Tunica County, Mississippi, 28143, 10477, 31211, 4811, 80000, 1641, 836, 805
Union County, Mississippi, 28145, 27811, 35865, 11686, 83200, 7340, 3493, 3847
Walthall County, Mississippi, 28147, 14978, 31384, 7147, 93200, 4917, 2050, 2867
Warren County, Mississippi, 28149, 48020, 41121, 21872, 100800, 11940, 6894, 5046
Washington County, Mississippi, 28151, 49499, 29144, 21650, 73900, 10010, 4825, 5185
Wayne County, Mississippi, 28153, 20564, 32557, 9210, 74300, 6487, 2238, 4249
Webster County, Mississippi, 28155, 9999, 34448, 4806, 78500, 3058, 1366, 1692
Wilkinson County, Mississippi, 28157, 9345, 29931, 5047, 59600, 2527, 942, 1585
Winston County, Mississippi, 28159, 18697, 33202, 8755, 78600, 5294, 2141, 3153
Yalobusha County, Mississippi, 28161, 12381, 36502, 6360, 74600, 3819, 1970, 1849
Yazoo County, Mississippi, 28163, 27911, 28961, 10055, 68500, 5268, 2188, 3080
Adair County, Missouri, 29001, 25560, 37516, 11309, 108000, 5636, 3037, 2599
Andrew County, Missouri, 29003, 17328, 55613, 7303, 127200, 5333, 3104, 2229
Atchison County, Missouri, 29005, 5440, 43933, 2969, 82300, 1711, 839, 872
Audrain County, Missouri, 29007, 25783, 41310, 10813, 91900, 6522, 3292, 3230
Barry County, Missouri, 29009, 35726, 39033, 17436, 113000, 9971, 5153, 4818
Barton County, Missouri, 29011, 12166, 37467, 5576, 93500, 3655, 1890, 1765
Bates County, Missouri, 29013, 16643, 41060, 7832, 103700, 4848, 2574, 2274
Benton County, Missouri, 29015, 18854, 33042, 14034, 111200, 6647, 3202, 3445
Bollinger County, Missouri, 29017, 12356, 39707, 5840, 97700, 3868, 1815, 2053
Boone County, Missouri, 29019, 170770, 49899, 72187, 169400, 37482, 26154, 11328
Buchanan County, Missouri, 29021, 89561, 46315, 38487, 109700, 21091, 12536, 8555
Butler County, Missouri, 29023, 42951, 35738, 19662, 93300, 10898, 5604, 5294
Caldwell County, Missouri, 29025, 9083, 43691, 4604, 97000, 2775, 1433, 1342
Callaway County, Missouri, 29027, 44566, 47744, 18539, 124200, 11898, 7214, 4684
Camden County, Missouri, 29029, 43927, 44816, 41234, 169700, 13178, 7661, 5517
Cape Girardeau County, Missouri, 29031, 77606, 46050, 32904, 142300, 19167, 11636, 7531
Carroll County, Missouri, 29033, 9096, 42415, 4603, 76400, 2718, 1218, 1500
Carter County, Missouri, 29035, 6284, 33034, 3235, 89200, 1750, 1024, 726
Cass County, Missouri, 29037, 100781, 61584, 40422, 159600, 28671, 19967, 8704
Cedar County, Missouri, 29039, 13892, 31532, 7180, 88900, 4117, 1998, 2119
Chariton County, Missouri, 29041, 7650, 40642, 4153, 75400, 2272, 833, 1439
Christian County, Missouri, 29043, 80904, 53270, 32340, 143100, 21835, 15257, 6578
Clark County, Missouri, 29045, 6919, 43883, 3451, 84000, 2165, 1047, 1118
Clay County, Missouri, 29047, 230361, 62099, 94546, 154900, 61320, 44088, 17232
Clinton County, Missouri, 29049, 20498, 54773, 8884, 135500, 5960, 3851, 2109
Cole County, Missouri, 29051, 76533, 53088, 32657, 149200, 19921, 12498, 7423
Cooper County, Missouri, 29053, 17593, 44549, 7459, 124000, 4624, 2853, 1771
Crawford County, Missouri, 29055, 24660, 36743, 11925, 111600, 6766, 3862, 2904
Dade County, Missouri, 29057, 7618, 37035, 3944, 79900, 2512, 1249, 1263
Dallas County, Missouri, 29059, 16564, 38062, 7595, 94600, 4752, 2345, 2407
Daviess County, Missouri, 29061, 8277, 41642, 4179, 102500, 2365, 1255, 1110
DeKalb County, Missouri, 29063, 12782, 41406, 4304, 110700, 2354, 1294, 1060
Dent County, Missouri, 29065, 15612, 36831, 7267, 88700, 4208, 2106, 2102
Douglas County, Missouri, 29067, 13516, 30508, 6465, 101200, 3943, 1743, 2200
Dunklin County, Missouri, 29069, 31562, 31077, 14352, 67500, 7964, 3712, 4252
Franklin County, Missouri, 29071, 101828, 48480, 43733, 149400, 29390, 18574, 10816
Gasconade County, Missouri, 29073, 14948, 42826, 8164, 120000, 4662, 2357, 2305
Gentry County, Missouri, 29075, 6785, 41912, 3205, 83400, 2015, 875, 1140
Greene County, Missouri, 29077, 283206, 41227, 128166, 129400, 68906, 44371, 24535
Grundy County, Missouri, 29079, 10256, 37656, 5003, 79800, 2847, 1228, 1619
Harrison County, Missouri, 29081, 8722, 39301, 4388, 74300, 2623, 1270, 1353
Henry County, Missouri, 29083, 22034, 42181, 10897, 91100, 7124, 3847, 3277
Hickory County, Missouri, 29085, 9335, 32122, 6754, 94800, 3332, 1560, 1772
Holt County, Missouri, 29087, 4615, 42500, 2779, 86200, 1516, 733, 783
Howard County, Missouri, 29089, 10182, 44820, 4541, 97900, 2769, 1481, 1288
Howell County, Missouri, 29091, 40326, 32784, 18054, 102800, 10902, 5824, 5078
Iron County, Missouri, 29093, 10322, 36239, 5293, 82600, 2824, 1410, 1414
Jackson County, Missouri, 29095, 680905, 46869, 314002, 125500, 162755, 110178, 52577
Jasper County, Missouri, 29097, 117184, 41811, 51108, 106300, 29156, 17903, 11253
Jefferson County, Missouri, 29099, 221577, 55348, 88584, 149900, 66417, 46425, 19992
Johnson County, Missouri, 29101, 54155, 49792, 21710, 141400, 12062, 7938, 4124
Knox County, Missouri, 29103, 4035, 38289, 2272, 71300, 1318, 478, 840
Laclede County, Missouri, 29105, 35514, 39712, 15768, 103400, 9491, 5616, 3875
Lafayette County, Missouri, 29107, 32916, 50723, 14718, 117400, 9982, 5607, 4375
Lawrence County, Missouri, 29109, 38244, 40597, 16573, 98100, 10315, 6130, 4185
Lewis County, Missouri, 29111, 10172, 43909, 4515, 83800, 2834, 1349, 1485
Lincoln County, Missouri, 29113, 53850, 53718, 21071, 144500, 14312, 10005, 4307
Linn County, Missouri, 29115, 12401, 37997, 6380, 75900, 3602, 1728, 1874
Livingston County, Missouri, 29117, 15042, 43350, 6741, 102500, 3991, 2077, 1914
McDonald County, Missouri, 29119, 22763, 38368, 9850, 88400, 5847, 3114, 2733
Macon County, Missouri, 29121, 15460, 36976, 7630, 88000, 4638, 2216, 2422
Madison County, Missouri, 29123, 12401, 35097, 5946, 89200, 3510, 1807, 1703
Maries County, Missouri, 29125, 9057, 39700, 4588, 118000, 2697, 1310, 1387
Marion County, Missouri, 29127, 28840, 40814, 12885, 103700, 7273, 3862, 3411
Mercer County, Missouri, 29129, 3718, 40768, 2119, 77500, 1141, 513, 628
Miller County, Missouri, 29131, 24956, 38094, 12739, 120800, 7334, 4015, 3319
Mississippi County, Missouri, 29133, 14208, 28347, 5703, 67700, 3102, 1581, 1521
Moniteau County, Missouri, 29135, 15801, 47725, 6144, 116500, 4021, 2323, 1698
Monroe County, Missouri, 29137, 8680, 43138, 4810, 90800, 2610, 1277, 1333
Montgomery County, Missouri, 29139, 11939, 39830, 6142, 105900, 3527, 1834, 1693
Morgan County, Missouri, 29141, 20225, 33525, 15421, 109300, 5961, 2893, 3068
New Madrid County, Missouri, 29143, 18411, 33630, 8529, 73100, 4443, 2166, 2277
Newton County, Missouri, 29145, 58777, 43290, 24340, 111700, 15888, 8946, 6942
Nodaway County, Missouri, 29147, 23186, 35854, 9614, 114500, 4665, 2194, 2471
Oregon County, Missouri, 29149, 10979, 29851, 5438, 79400, 3290, 1620, 1670
Osage County, Missouri, 29151, 13758, 52693, 6559, 131900, 4222, 1928, 2294
Ozark County, Missouri, 29153, 9537, 31399, 5627, 86600, 3265, 1375, 1890
Pemiscot County, Missouri, 29155, 17837, 29238, 8115, 65200, 3743, 1849, 1894
Perry County, Missouri, 29157, 19100, 51499, 8605, 123400, 5816, 3123, 2693
Pettis County, Missouri, 29159, 42215, 39928, 18203, 101400, 10971, 6323, 4648
Phelps County, Missouri, 29161, 45029, 41618, 19714, 114500, 10180, 5689, 4491
Pike County, Missouri, 29163, 18517, 41750, 7829, 95000, 4748, 2353, 2395
Platte County, Missouri, 29165, 93394, 68254, 39876, 190300, 24272, 17663, 6609
Polk County, Missouri, 29167, 31107, 41130, 13331, 114600, 7866, 4651, 3215
Pulaski County, Missouri, 29169, 53443, 47931, 18382, 129800, 7508, 4585, 2923
Putnam County, Missouri, 29171, 4895, 36346, 2962, 82800, 1629, 788, 841
Ralls County, Missouri, 29173, 10243, 47345, 5137, 112100, 3231, 1835, 1396
Randolph County, Missouri, 29175, 25135, 37832, 10671, 85500, 6130, 3146, 2984
Ray County, Missouri, 29177, 23031, 52526, 9966, 120200, 6616, 3945, 2671
Reynolds County, Missouri, 29179, 6578, 35648, 4015, 85600, 2081, 893, 1188
Ripley County, Missouri, 29181, 13990, 32444, 6550, 80800, 4078, 1825, 2253
St. Charles County, Missouri, 29183, 374805, 72415, 145704, 188200, 110058, 82624, 27434
St. Clair County, Missouri, 29185, 9520, 32046, 5599, 79600, 3044, 1403, 1641
Ste. Genevieve County, Missouri, 29186, 17990, 47014, 8621, 131000, 5759, 3095, 2664
St. Francois County, Missouri, 29187, 66010, 39741, 29187, 103500, 16545, 9651, 6894
St. Louis County, Missouri, 29189, 1001327, 59755, 438076, 173400, 282099, 194507, 87592
Saline County, Missouri, 29195, 23334, 40101, 10083, 89700, 5993, 3349, 2644
Schuyler County, Missouri, 29197, 4395, 37500, 2087, 86000, 1274, 558, 716
Scotland County, Missouri, 29199, 4873, 39772, 2351, 75100, 1374, 700, 674
Scott County, Missouri, 29201, 39061, 39162, 16999, 94300, 10384, 5862, 4522
Shannon County, Missouri, 29203, 8317, 32404, 4126, 89400, 2546, 1081, 1465
Shelby County, Missouri, 29205, 6179, 39087, 3189, 72600, 1779, 787, 992
Stoddard County, Missouri, 29207, 29837, 38203, 13602, 90500, 8505, 4543, 3962
Stone County, Missouri, 29209, 31375, 40510, 20522, 153100, 10148, 5519, 4629
Sullivan County, Missouri, 29211, 6512, 40197, 3343, 78800, 1803, 829, 974
Taney County, Missouri, 29213, 53555, 38357, 29986, 121700, 12763, 7363, 5400
Texas County, Missouri, 29215, 25735, 35088, 11609, 99300, 6822, 3365, 3457
Vernon County, Missouri, 29217, 20878, 40693, 9477, 90800, 5412, 2704, 2708
Warren County, Missouri, 29219, 33043, 51133, 14893, 152800, 9451, 6296, 3155
Washington County, Missouri, 29221, 25048, 35305, 10897, 79700, 7146, 3476, 3670
Wayne County, Missouri, 29223, 13397, 33750, 8001, 70000, 4221, 1993, 2228
Webster County, Missouri, 29225, 36690, 44451, 14468, 118700, 9517, 6022, 3495
Worth County, Missouri, 29227, 2082, 45952, 1274, 57800, 672, 251, 421
Wright County, Missouri, 29229, 18449, 29778, 8628, 88200, 5094, 2353, 2741
St. Louis city, Missouri, 29510, 317850, 35599, 175591, 120400, 61266, 41209, 20057
Beaverhead County, Montana, 30001, 9291, 41512, 5259, 168800, 2605, 1186, 1419
Big Horn County, Montana, 30003, 13141, 41622, 4677, 88500, 2194, 694, 1500
Blaine County, Montana, 30005, 6598, 36744, 2819, 82500, 1396, 411, 985
Broadwater County, Montana, 30007, 5692, 50115, 2699, 184600, 1891, 1135, 756
Carbon County, Montana, 30009, 10268, 49767, 6473, 217500, 3412, 1799, 1613
Carter County, Montana, 30011, 1227, 45000, 796, 87500, 428, 110, 318
Cascade County, Montana, 30013, 82090, 45205, 37553, 162100, 21469, 12446, 9023
Chouteau County, Montana, 30015, 5855, 38521, 2869, 123800, 1381, 481, 900
Custer County, Montana, 30017, 11945, 48750, 5585, 137300, 3334, 1829, 1505
Daniels County, Montana, 30019, 1758, 49239, 1118, 112600, 669, 294, 375
Dawson County, Montana, 30021, 9365, 52738, 4317, 156500, 2755, 1245, 1510
Deer Lodge County, Montana, 30023, 9211, 39399, 5131, 130100, 2747, 1355, 1392
Fallon County, Montana, 30025, 3057, 53266, 1479, 143000, 863, 415, 448
Fergus County, Montana, 30027, 11468, 40881, 5825, 121700, 3439, 1704, 1735
Flathead County, Montana, 30029, 93333, 47851, 47283, 231500, 26318, 16110, 10208
Gallatin County, Montana, 30031, 95323, 55553, 43996, 271500, 23556, 15386, 8170
Garfield County, Montana, 30033, 1047, 39732, 835, 150000, 326, 82, 244
Glacier County, Montana, 30035, 13672, 29640, 5328, 91300, 2467, 750, 1717
Golden Valley County, Montana, 30037, 756, 40938, 456, 95000, 238, 63, 175
Granite County, Montana, 30039, 3168, 48512, 2809, 216300, 1063, 434, 629
Hill County, Montana, 30041, 16523, 44633, 7232, 128800, 4160, 2200, 1960
Jefferson County, Montana, 30043, 11502, 60842, 5047, 242300, 3756, 2231, 1525
Judith Basin County, Montana, 30045, 1997, 44602, 1327, 122000, 693, 291, 402
Lake County, Montana, 30047, 29157, 38732, 16613, 220200, 8325, 4397, 3928
Lewis and Clark County, Montana, 30049, 65357, 56197, 30554, 208600, 18558, 11562, 6996
Liberty County, Montana, 30051, 2369, 47768, 1125, 103800, 570, 220, 350
Lincoln County, Montana, 30053, 19337, 35275, 11498, 164400, 6789, 3278, 3511
McCone County, Montana, 30055, 1728, 40750, 1029, 112400, 603, 156, 447
Madison County, Montana, 30057, 7767, 46250, 6931, 237800, 2514, 1202, 1312
Meagher County, Montana, 30059, 1898, 41641, 1350, 139500, 552, 236, 316
Mineral County, Montana, 30061, 4238, 36031, 2457, 169600, 1134, 576, 558
Missoula County, Montana, 30063, 111966, 46164, 51056, 239700, 27228, 17003, 10225
Musselshell County, Montana, 30065, 4790, 39517, 2708, 133800, 1434, 696, 738
Park County, Montana, 30067, 15708, 43932, 9367, 216900, 5014, 2666, 2348
Petroleum County, Montana, 30069, 443, 43750, 309, 78600, 143, 49, 94
Phillips County, Montana, 30071, 4167, 36071, 2315, 121800, 1308, 435, 873
Pondera County, Montana, 30073, 6206, 42264, 2637, 111900, 1586, 711, 875
Powder River County, Montana, 30075, 1703, 46346, 1021, 107800, 526, 187, 339
Powell County, Montana, 30077, 6975, 40000, 3090, 119500, 1644, 677, 967
Prairie County, Montana, 30079, 1372, 42383, 673, 80900, 502, 133, 369
Ravalli County, Montana, 30081, 40823, 39480, 19566, 239000, 11576, 6849, 4727
Richland County, Montana, 30083, 11132, 65084, 4916, 179700, 2834, 1259, 1575
Roosevelt County, Montana, 30085, 11072, 32974, 4067, 102700, 1795, 541, 1254
Rosebud County, Montana, 30087, 9352, 51159, 4105, 127900, 2257, 1060, 1197
Sanders County, Montana, 30089, 11346, 32257, 6662, 180800, 3720, 1899, 1821
Sheridan County, Montana, 30091, 3630, 50664, 2107, 143700, 1242, 505, 737
Silver Bow County, Montana, 30093, 34549, 37749, 16776, 128100, 9789, 5306, 4483
Stillwater County, Montana, 30095, 9288, 58259, 4817, 202000, 3001, 1801, 1200
Sweet Grass County, Montana, 30097, 3633, 50588, 1995, 191800, 1024, 495, 529
Teton County, Montana, 30099, 6074, 46360, 2877, 143800, 1713, 814, 899
Toole County, Montana, 30101, 5150, 44804, 2338, 122600, 1191, 513, 678
Treasure County, Montana, 30103, 812, 41103, 437, 86100, 225, 55, 170
Valley County, Montana, 30105, 7577, 49141, 4843, 122000, 2248, 966, 1282
Wheatland County, Montana, 30107, 2115, 32723, 1343, 83300, 593, 215, 378
Wibaux County, Montana, 30109, 986, 38553, 558, 106100, 315, 102, 213
Yellowstone County, Montana, 30111, 153692, 52802, 65792, 192500, 41950, 27450, 14500
Adams County, Nebraska, 31001, 31442, 50635, 13618, 104300, 8804, 4531, 4273
Antelope County, Nebraska, 31003, 6486, 45609, 3261, 78100, 2133, 770, 1363
Arthur County, Nebraska, 31005, 448, 39375, 253, 100000, 106, 32, 74
Banner County, Nebraska, 31007, 820, 48897, 406, 122100, 228, 127, 101
Blaine County, Nebraska, 31009, 551, 48875, 341, 72500, 123, 34, 89
Boone County, Nebraska, 31011, 5373, 50306, 2637, 97700, 1753, 634, 1119
Box Butte County, Nebraska, 31013, 11310, 51691, 5448, 92000, 3182, 1674, 1508
Boyd County, Nebraska, 31015, 2039, 40224, 1370, 51700, 753, 207, 546
Brown County, Nebraska, 31017, 3078, 36078, 1855, 70500, 1047, 377, 670
Buffalo County, Nebraska, 31019, 47958, 53624, 19531, 151300, 11617, 7159, 4458
Burt County, Nebraska, 31021, 6647, 47429, 3461, 88700, 2226, 1037, 1189
Butler County, Nebraska, 31023, 8256, 51027, 4043, 100200, 2796, 1356, 1440
Cass County, Nebraska, 31025, 25360, 65619, 11225, 155900, 7880, 5488, 2392
Cedar County, Nebraska, 31027, 8675, 52250, 4136, 101400, 2917, 1210, 1707
Chase County, Nebraska, 31029, 3897, 52422, 1909, 91200, 1326, 580, 746
Cherry County, Nebraska, 31031, 5770, 48750, 3150, 114200, 1740, 880, 860
Cheyenne County, Nebraska, 31033, 10077, 53814, 4917, 113700, 3022, 1704, 1318
Clay County, Nebraska, 31035, 6382, 51470, 2984, 81100, 2031, 882, 1149
Colfax County, Nebraska, 31037, 10522, 51367, 4107, 88300, 2689, 1377, 1312
Cuming County, Nebraska, 31039, 9078, 50013, 4196, 102500, 2601, 1195, 1406
Custer County, Nebraska, 31041, 10802, 46468, 5566, 86700, 3453, 1661, 1792
Dakota County, Nebraska, 31043, 20798, 49786, 7727, 111400, 4760, 2870, 1890
Dawes County, Nebraska, 31045, 9136, 41038, 4226, 104600, 2383, 1243, 1140
Dawson County, Nebraska, 31047, 24069, 48329, 10139, 88800, 5928, 3197, 2731
Deuel County, Nebraska, 31049, 1946, 50962, 989, 69400, 617, 278, 339
Dixon County, Nebraska, 31051, 5866, 51223, 2681, 80900, 1751, 817, 934
Dodge County, Nebraska, 31053, 36725, 49068, 16606, 114000, 10059, 5698, 4361
Douglas County, Nebraska, 31055, 537655, 54659, 225046, 145900, 128781, 92339, 36442
Dundy County, Nebraska, 31057, 2015, 42500, 1130, 71900, 586, 188, 398
Fillmore County, Nebraska, 31059, 5697, 52316, 2914, 75700, 1868, 705, 1163
Franklin County, Nebraska, 31061, 3105, 45905, 1720, 59900, 1178, 399, 779
Frontier County, Nebraska, 31063, 2573, 49634, 1538, 87400, 804, 334, 470
Furnas County, Nebraska, 31065, 4887, 39934, 2712, 62300, 1604, 611, 993
Gage County, Nebraska, 31067, 21818, 50010, 10419, 108300, 6570, 3240, 3330
Garden County, Nebraska, 31069, 1823, 45845, 1322, 75000, 700, 271, 429
Garfield County, Nebraska, 31071, 1933, 43179, 1191, 89100, 685, 296, 389
Gosper County, Nebraska, 31073, 1976, 54375, 1251, 108500, 565, 283, 282
Grant County, Nebraska, 31075, 769, 44750, 418, 50800, 209, 49, 160
Greeley County, Nebraska, 31077, 2476, 42904, 1293, 59600, 806, 257, 549
Hall County, Nebraska, 31079, 60792, 49252, 23982, 122500, 13919, 8505, 5414
Hamilton County, Nebraska, 31081, 9100, 59311, 4028, 111600, 2919, 1683, 1236
Harlan County, Nebraska, 31083, 3458, 46766, 2390, 78200, 1224, 582, 642
Hayes County, Nebraska, 31085, 1084, 44500, 543, 73500, 324, 101, 223
Hitchcock County, Nebraska, 31087, 2879, 39231, 1753, 59100, 973, 330, 643
Holt County, Nebraska, 31089, 10398, 46728, 5210, 95600, 3271, 1613, 1658
Hooker County, Nebraska, 31091, 681, 37317, 440, 70000, 238, 62, 176
Howard County, Nebraska, 31093, 6347, 50030, 2994, 109200, 2007, 1105, 902
Jefferson County, Nebraska, 31095, 7433, 43008, 3902, 71000, 2552, 1121, 1431
Johnson County, Nebraska, 31097, 5167, 45429, 2150, 76800, 1389, 646, 743
Kearney County, Nebraska, 31099, 6549, 51934, 2922, 109900, 1883, 940, 943
Keith County, Nebraska, 31101, 8146, 41781, 5381, 99700, 2599, 1395, 1204
Keya Paha County, Nebraska, 31103, 711, 38625, 488, 74400, 243, 60, 183
Kimball County, Nebraska, 31105, 3720, 40242, 1933, 80100, 1020, 482, 538
Knox County, Nebraska, 31107, 8556, 45411, 4801, 81200, 2731, 1002, 1729
Lancaster County, Nebraska, 31109, 298080, 51830, 123773, 152900, 69852, 48753, 21099
Lincoln County, Nebraska, 31111, 35896, 50194, 16615, 114200, 9973, 5778, 4195
Logan County, Nebraska, 31113, 851, 48281, 415, 114300, 252, 142, 110
Loup County, Nebraska, 31115, 548, 55417, 442, 96300, 199, 70, 129
McPherson County, Nebraska, 31117, 433, 54306, 244, 133300, 128, 45, 83
Madison County, Nebraska, 31119, 35111, 50218, 15070, 118300, 9093, 5306, 3787
Merrick County, Nebraska, 31121, 7776, 51012, 3724, 85600, 2434, 1133, 1301
Morrill County, Nebraska, 31123, 4874, 45910, 2421, 80600, 1371, 748, 623
Nance County, Nebraska, 31125, 3639, 42500, 1824, 78400, 1172, 517, 655
Nemaha County, Nebraska, 31127, 7168, 49656, 3498, 102200, 2044, 993, 1051
Nuckolls County, Nebraska, 31129, 4391, 40488, 2444, 54500, 1530, 441, 1089
Otoe County, Nebraska, 31131, 15842, 50275, 7053, 115800, 4725, 2725, 2000
Pawnee County, Nebraska, 31133, 2726, 41161, 1593, 63800, 980, 325, 655
Perkins County, Nebraska, 31135, 2924, 55893, 1451, 97700, 960, 445, 515
Phelps County, Nebraska, 31137, 9216, 50404, 4197, 110000, 2684, 1503, 1181
Pierce County, Nebraska, 31139, 7184, 54482, 3224, 98500, 2255, 1074, 1181
Platte County, Nebraska, 31141, 32642, 56318, 13541, 125200, 9251, 5279, 3972
Polk County, Nebraska, 31143, 5271, 57312, 2723, 103400, 1684, 774, 910
Red Willow County, Nebraska, 31145, 10946, 42931, 5279, 86100, 3394, 1624, 1770
Richardson County, Nebraska, 31147, 8201, 42750, 4382, 72000, 2813, 1191, 1622
Rock County, Nebraska, 31149, 1401, 48456, 916, 70800, 518, 200, 318
Saline County, Nebraska, 31151, 14360, 51738, 5784, 95700, 3263, 1529, 1734
Sarpy County, Nebraska, 31153, 169192, 70543, 64886, 163800, 43241, 33529, 9712
Saunders County, Nebraska, 31155, 20913, 60854, 9331, 150600, 6303, 3710, 2593
Scotts Bluff County, Nebraska, 31157, 36684, 45992, 16354, 107700, 10103, 5949, 4154
Seward County, Nebraska, 31159, 16998, 59662, 6966, 147800, 4514, 2620, 1894
Sheridan County, Nebraska, 31161, 5294, 41985, 2919, 70200, 1602, 601, 1001
Sherman County, Nebraska, 31163, 3107, 46366, 1937, 86600, 1072, 480, 592
Sioux County, Nebraska, 31165, 1249, 41215, 800, 89600, 423, 174, 249
Stanton County, Nebraska, 31167, 6081, 53416, 2637, 103400, 1959, 1002, 957
Thayer County, Nebraska, 31169, 5182, 45741, 2723, 64700, 1855, 750, 1105
Thomas County, Nebraska, 31171, 675, 51000, 390, 84300, 217, 78, 139
Thurston County, Nebraska, 31173, 6946, 41266, 2396, 68600, 1288, 505, 783
Valley County, Nebraska, 31175, 4254, 44612, 2275, 84700, 1357, 605, 752
Washington County, Nebraska, 31177, 20257, 65370, 8372, 175800, 6361, 4310, 2051
Wayne County, Nebraska, 31179, 9425, 54159, 3811, 116100, 2155, 1049, 1106
Webster County, Nebraska, 31181, 3697, 40256, 1909, 77600, 1213, 487, 726
Wheeler County, Nebraska, 31183, 847, 46394, 563, 88100, 287, 80, 207
York County, Nebraska, 31185, 13825, 51802, 6276, 117600, 3850, 2059, 1791
Churchill County, Nevada, 32001, 24252, 47415, 10738, 151000, 5818, 3627, 2191
Clark County, Nevada, 32003, 2035572, 51575, 857131, 170400, 380425, 277536, 102889
Douglas County, Nevada, 32005, 47259, 58535, 23710, 272000, 13735, 8661, 5074
Elko County, Nevada, 32007, 51562, 71799, 20192, 184600, 12438, 7480, 4958
Esmeralda County, Nevada, 32009, 1141, 39271, 1003, 79800, 289, 97, 192
Eureka County, Nevada, 32011, 1669, 60250, 1121, 93100, 545, 184, 361
Humboldt County, Nevada, 32013, 17067, 65212, 7193, 159900, 4515, 2532, 1983
Lander County, Nevada, 32015, 5946, 78190, 2484, 109500, 1664, 630, 1034
Lincoln County, Nevada, 32017, 5194, 44866, 2671, 128900, 1277, 735, 542
Lyon County, Nevada, 32019, 51657, 47255, 22419, 131700, 13702, 8700, 5002
Mineral County, Nevada, 32021, 4566, 38923, 2714, 83800, 1272, 492, 780
Nye County, Nevada, 32023, 42625, 41712, 21903, 105900, 12287, 6525, 5762
Pershing County, Nevada, 32027, 6722, 45230, 2418, 105200, 1320, 635, 685
Storey County, Nevada, 32029, 3929, 64832, 1982, 177000, 1546, 1020, 526
Washoe County, Nevada, 32031, 435019, 52870, 186481, 213100, 94470, 66373, 28097
White Pine County, Nevada, 32033, 9974, 57122, 4453, 124900, 2386, 1067, 1319
Carson City, Nevada, 32510, 54482, 47668, 23470, 186000, 12104, 7553, 4551
Belknap County, New Hampshire, 33001, 60399, 62159, 37611, 219600, 18434, 11589, 6845
Carroll County, New Hampshire, 33003, 47513, 53306, 40127, 222300, 16861, 9317, 7544
Cheshire County, New Hampshire, 33005, 76430, 57782, 34905, 188800, 21732, 13888, 7844
Coos County, New Hampshire, 33007, 31870, 42312, 21284, 123500, 9943, 4993, 4950
Grafton County, New Hampshire, 33009, 89341, 55762, 51590, 211500, 23902, 13683, 10219
Hillsborough County, New Hampshire, 33011, 403972, 71244, 167207, 245700, 103496, 76239, 27257
Merrimack County, New Hampshire, 33013, 147262, 65983, 63653, 225200, 40881, 27741, 13140
Rockingham County, New Hampshire, 33015, 299006, 81198, 127994, 282500, 90387, 65336, 25051
Strafford County, New Hampshire, 33017, 125273, 60711, 52237, 216500, 30600, 20146, 10454
Sullivan County, New Hampshire, 33019, 43135, 56032, 22342, 171000, 12939, 8452, 4487
Atlantic County, New Jersey, 34001, 275376, 54461, 127435, 225600, 68194, 46495, 21699
Bergen County, New Jersey, 34003, 926330, 85806, 353978, 441100, 217504, 144789, 72715
Burlington County, New Jersey, 34005, 450556, 78621, 177058, 245000, 125905, 90932, 34973
Camden County, New Jersey, 34007, 511998, 62185, 205768, 196800, 125702, 88421, 37281
Cape May County, New Jersey, 34009, 95805, 57637, 98747, 299700, 30683, 18970, 11713
Cumberland County, New Jersey, 34011, 157035, 49984, 56216, 162400, 33402, 21107, 12295
Essex County, New Jersey, 34013, 791609, 53976, 313824, 356600, 123847, 90262, 33585
Gloucester County, New Jersey, 34015, 290298, 76727, 111445, 214500, 82968, 59074, 23894
Hudson County, New Jersey, 34017, 662619, 59741, 274423, 335300, 78089, 54615, 23474
Hunterdon County, New Jersey, 34019, 126250, 105444, 49816, 390900, 39142, 28457, 10685
Mercer County, New Jersey, 34021, 370212, 72804, 143833, 276500, 84045, 59329, 24716
Middlesex County, New Jersey, 34023, 830300, 79593, 297940, 323300, 181312, 124301, 57011
Monmouth County, New Jersey, 34025, 629185, 85242, 259823, 385100, 173378, 121506, 51872
Morris County, New Jersey, 34027, 498192, 100214, 190765, 423400, 135442, 96821, 38621
Ocean County, New Jersey, 34029, 583450, 61994, 279989, 262700, 178850, 112034, 66816
Passaic County, New Jersey, 34031, 507574, 59739, 176433, 336100, 86688, 59902, 26786
Salem County, New Jersey, 34033, 65120, 61831, 27619, 187800, 17638, 10798, 6840
Somerset County, New Jersey, 34035, 330604, 100667, 124672, 399000, 88277, 62527, 25750
Sussex County, New Jersey, 34037, 145930, 86565, 62184, 270600, 44938, 33532, 11406
Union County, New Jersey, 34039, 548744, 69594, 200708, 345500, 109992, 76793, 33199
Warren County, New Jersey, 34041, 107226, 70471, 45266, 255300, 30111, 21608, 8503
Bernalillo County, New Mexico, 35001, 673943, 47725, 287054, 185500, 163821, 111542, 52279
Catron County, New Mexico, 35003, 3583, 42973, 3785, 166000, 1285, 295, 990
Chaves County, New Mexico, 35005, 65811, 40630, 26709, 99700, 15611, 7949, 7662
Cibola County, New Mexico, 35006, 27382, 34565, 11088, 88200, 6328, 2227, 4101
Colfax County, New Mexico, 35007, 12997, 32380, 10067, 117700, 3871, 1645, 2226
Curry County, New Mexico, 35009, 50497, 41084, 20574, 125600, 10601, 6216, 4385
De Baca County, New Mexico, 35011, 2020, 32500, 967, 67000, 415, 130, 285
Do?a Ana County, New Mexico, 35013, 213963, 38853, 83586, 138100, 48445, 27080, 21365
Eddy County, New Mexico, 35015, 55641, 56618, 23166, 124800, 15057, 8370, 6687
Grant County, New Mexico, 35017, 29119, 38311, 14644, 132800, 9005, 4093, 4912
Guadalupe County, New Mexico, 35019, 4526, 30772, 2261, 82200, 863, 344, 519
Harding County, New Mexico, 35021, 565, 33393, 512, 65500, 157, 16, 141
Hidalgo County, New Mexico, 35023, 4643, 34444, 2383, 78200, 1243, 388, 855
Lea County, New Mexico, 35025, 68149, 57533, 25117, 108600, 14898, 7138, 7760
Lincoln County, New Mexico, 35027, 19931, 40708, 17636, 161900, 6696, 3399, 3297
Los Alamos County, New Mexico, 35028, 17939, 101934, 8313, 274200, 5649, 3711, 1938
Luna County, New Mexico, 35029, 24789, 27476, 10972, 81900, 6097, 2294, 3803
McKinley County, New Mexico, 35031, 73998, 28772, 25780, 68300, 13490, 3610, 9880
Mora County, New Mexico, 35033, 4660, 23822, 3247, 84300, 1324, 281, 1043
Otero County, New Mexico, 35035, 65318, 39775, 30967, 101800, 15218, 7745, 7473
Quay County, New Mexico, 35037, 8698, 29113, 5551, 76300, 2380, 841, 1539
Rio Arriba County, New Mexico, 35039, 39949, 36098, 19564, 155900, 10661, 3935, 6726
Roosevelt County, New Mexico, 35041, 19908, 35546, 8294, 118500, 4170, 2198, 1972
Sandoval County, New Mexico, 35043, 136638, 58982, 53675, 177400, 38853, 27179, 11674
San Juan County, New Mexico, 35045, 125133, 48671, 49562, 145400, 29820, 14496, 15324
San Miguel County, New Mexico, 35047, 28668, 29237, 15558, 121200, 7783, 3077, 4706
Santa Fe County, New Mexico, 35049, 147108, 54315, 71673, 275200, 42266, 26232, 16034
Sierra County, New Mexico, 35051, 11615, 29356, 8304, 98800, 3644, 1357, 2287
Socorro County, New Mexico, 35053, 17494, 34037, 8010, 117800, 3597, 1179, 2418
Taos County, New Mexico, 35055, 32943, 36582, 20316, 216200, 9534, 4088, 5446
Torrance County, New Mexico, 35057, 15853, 32083, 7769, 106400, 4475, 2387, 2088
Union County, New Mexico, 35059, 4339, 36070, 2299, 87400, 1009, 454, 555
Valencia County, New Mexico, 35061, 76297, 41703, 30162, 131900, 21410, 12851, 8559
Albany County, New York, 36001, 307463, 59887, 138081, 208400, 72000, 46107, 25893
Allegany County, New York, 36003, 48070, 42776, 26024, 70300, 13373, 6630, 6743
Bronx County, New York, 36005, 1428357, 34299, 520329, 363400, 91993, 56636, 35357
Broome County, New York, 36007, 198093, 46261, 90026, 109900, 51992, 29109, 22883
Cattaraugus County, New York, 36009, 78962, 42601, 41034, 84600, 22560, 11460, 11100
Cayuga County, New York, 36011, 79173, 52082, 36405, 113600, 22028, 13054, 8974
Chautauqua County, New York, 36013, 132646, 42993, 66741, 84500, 37284, 20026, 17258
Chemung County, New York, 36015, 88267, 50320, 38382, 100400, 24286, 14605, 9681
Chenango County, New York, 36017, 49549, 45668, 24742, 91700, 14785, 7453, 7332
Clinton County, New York, 36019, 81685, 49930, 35918, 124200, 21713, 11935, 9778
Columbia County, New York, 36021, 62195, 59105, 32802, 222100, 18141, 10581, 7560
Cortland County, New York, 36023, 49043, 49514, 20527, 108200, 11788, 6570, 5218
Delaware County, New York, 36025, 46901, 43720, 31202, 132400, 14000, 6767, 7233
Dutchess County, New York, 36027, 296928, 71904, 118996, 275600, 73727, 51302, 22425
Erie County, New York, 36029, 921584, 51247, 420782, 130000, 248889, 155357, 93532
Essex County, New York, 36031, 38912, 52758, 25678, 145100, 11275, 5701, 5574
Franklin County, New York, 36033, 51280, 47923, 25293, 101600, 13927, 7016, 6911
Fulton County, New York, 36035, 54606, 46969, 28617, 108200, 15684, 8536, 7148
Genesee County, New York, 36037, 59458, 50880, 25636, 107000, 17467, 10562, 6905
Greene County, New York, 36039, 48312, 50278, 29276, 177700, 13261, 7541, 5720
Hamilton County, New York, 36041, 4760, 48243, 8757, 162600, 1177, 470, 707
Herkimer County, New York, 36043, 64034, 46229, 33345, 96100, 18556, 9673, 8883
Jefferson County, New York, 36045, 118947, 49505, 58536, 141000, 24610, 15095, 9515
Kings County, New York, 36047, 2595259, 48201, 1017282, 570200, 272717, 172271, 100446
Lewis County, New York, 36049, 27124, 49819, 15249, 117300, 8066, 4146, 3920
Livingston County, New York, 36051, 64801, 51734, 27249, 121200, 17624, 10767, 6857
Madison County, New York, 36053, 72427, 54145, 31742, 124900, 19755, 12165, 7590
Monroe County, New York, 36055, 749356, 52553, 323313, 138600, 192326, 130223, 62103
Montgomery County, New York, 36057, 49779, 43764, 23184, 101600, 13109, 7085, 6024
Nassau County, New York, 36059, 1354612, 99465, 467256, 446400, 353777, 231114, 122663
New York County, New York, 36061, 1629507, 72871, 862289, 848700, 172079, 91782, 80297
Niagara County, New York, 36063, 214150, 49449, 99170, 108000, 62294, 36551, 25743
Oneida County, New York, 36065, 233558, 48246, 104006, 114000, 59675, 34273, 25402
Onondaga County, New York, 36067, 468304, 55092, 203956, 135900, 120529, 79234, 41295
Ontario County, New York, 36069, 109192, 57416, 49418, 145700, 32228, 20921, 11307
Orange County, New York, 36071, 375384, 70848, 139103, 262500, 86184, 61469, 24715
Orleans County, New York, 36073, 42204, 46359, 18498, 91300, 12112, 7415, 4697
Oswego County, New York, 36075, 121183, 47860, 53656, 94800, 32675, 19565, 13110
Otsego County, New York, 36077, 61399, 48588, 30665, 142800, 17352, 9249, 8103
Putnam County, New York, 36079, 99488, 96148, 38289, 354900, 27946, 20098, 7848
Queens County, New York, 36081, 2301139, 57720, 844189, 450300, 340561, 208490, 132071
Rensselaer County, New York, 36083, 159900, 60709, 71742, 179100, 41240, 27830, 13410
Richmond County, New York, 36085, 472481, 73197, 178136, 439500, 114000, 80370, 33630
Rockland County, New York, 36087, 320688, 84855, 104442, 419100, 68107, 47935, 20172
St. Lawrence County, New York, 36089, 112011, 44705, 52203, 87600, 29600, 15701, 13899
Saratoga County, New York, 36091, 223774, 71496, 100953, 232900, 64423, 43151, 21272
Schenectady County, New York, 36093, 154796, 58114, 68171, 165800, 37747, 24949, 12798
Schoharie County, New York, 36095, 31913, 51195, 17201, 147000, 9512, 5407, 4105
Schuyler County, New York, 36097, 18410, 47680, 9513, 108500, 5933, 3042, 2891
Seneca County, New York, 36099, 35144, 49292, 16161, 97000, 9806, 5661, 4145
Steuben County, New York, 36101, 98665, 47280, 48849, 91000, 28756, 14761, 13995
Suffolk County, New York, 36103, 1501373, 88663, 570194, 375100, 392390, 273748, 118642
Sullivan County, New York, 36105, 76330, 50710, 49548, 165900, 18611, 10071, 8540
Tioga County, New York, 36107, 50199, 57514, 22183, 112600, 15585, 8746, 6839
Tompkins County, New York, 36109, 103855, 52624, 41983, 176500, 21356, 12905, 8451
Ulster County, New York, 36111, 181300, 58918, 83733, 222800, 47908, 28892, 19016
Warren County, New York, 36113, 65180, 56798, 38928, 189700, 18890, 11092, 7798
Washington County, New York, 36115, 62700, 51143, 28994, 142700, 17531, 10430, 7101
Wayne County, New York, 36117, 92416, 50798, 41386, 112900, 28288, 17462, 10826
Westchester County, New York, 36119, 967315, 83958, 370032, 506900, 210195, 139945, 70250
Wyoming County, New York, 36121, 41446, 52564, 18037, 102000, 11865, 7056, 4809
Yates County, New York, 36123, 25187, 49510, 13693, 124200, 7454, 4057, 3397
Alamance County, North Carolina, 37001, 155258, 41814, 67804, 138100, 40273, 24882, 15391
Alexander County, North Carolina, 37003, 37158, 39365, 16177, 124600, 10257, 5493, 4764
Alleghany County, North Carolina, 37005, 10911, 36968, 8128, 146600, 3642, 1836, 1806
Anson County, North Carolina, 37007, 26135, 33228, 11528, 76900, 6275, 2816, 3459
Ashe County, North Carolina, 37009, 27114, 36267, 17441, 151500, 8886, 4130, 4756
Avery County, North Carolina, 37011, 17695, 37777, 13988, 137100, 5307, 2357, 2950
Beaufort County, North Carolina, 37013, 47561, 40391, 25217, 115100, 13104, 6650, 6454
Bertie County, North Carolina, 37015, 20518, 30027, 9767, 78400, 5447, 2764, 2683
Bladen County, North Carolina, 37017, 34720, 30096, 17637, 85000, 9690, 4535, 5155
Brunswick County, North Carolina, 37019, 115926, 46859, 80412, 182500, 37423, 22701, 14722
Buncombe County, North Carolina, 37021, 247336, 45167, 115426, 192400, 64626, 38272, 26354
Burke County, North Carolina, 37023, 89548, 39360, 40711, 113100, 24366, 13501, 10865
Cabarrus County, North Carolina, 37025, 188375, 54720, 74504, 167100, 47681, 35572, 12109
Caldwell County, North Carolina, 37027, 81758, 35763, 37633, 108100, 22321, 12604, 9717
Camden County, North Carolina, 37029, 10161, 58780, 4129, 209800, 3197, 2069, 1128
Carteret County, North Carolina, 37031, 68228, 48457, 48694, 196800, 21029, 11862, 9167
Caswell County, North Carolina, 37033, 23174, 37869, 10582, 98400, 6758, 3677, 3081
Catawba County, North Carolina, 37035, 154610, 44376, 67820, 132700, 40729, 25570, 15159
Chatham County, North Carolina, 37037, 67431, 56642, 29632, 223500, 20793, 12014, 8779
Cherokee County, North Carolina, 37039, 27092, 34662, 17667, 142600, 8571, 4118, 4453
Chowan County, North Carolina, 37041, 14656, 38759, 7266, 135900, 3983, 2171, 1812
Clay County, North Carolina, 37043, 10656, 37076, 7195, 147900, 3474, 1877, 1597
Cleveland County, North Carolina, 37045, 97178, 39453, 43291, 104400, 25546, 13916, 11630
Columbus County, North Carolina, 37047, 57230, 34949, 25912, 83900, 15422, 7180, 8242
Craven County, North Carolina, 37049, 104450, 47985, 45745, 154500, 25127, 15882, 9245
Cumberland County, North Carolina, 37051, 324603, 44171, 142119, 129300, 64493, 45119, 19374
Currituck County, North Carolina, 37053, 24492, 60600, 14849, 229900, 7536, 5375, 2161
Dare County, North Carolina, 37055, 34863, 54496, 33863, 283400, 10189, 7069, 3120
Davidson County, North Carolina, 37057, 163867, 43363, 72895, 132200, 46221, 28834, 17387
Davie County, North Carolina, 37059, 41447, 51527, 18205, 169300, 12546, 7607, 4939
Duplin County, North Carolina, 37061, 59453, 35035, 25584, 87900, 14911, 7441, 7470
Durham County, North Carolina, 37063, 288817, 52503, 125685, 183800, 62241, 47401, 14840
Edgecombe County, North Carolina, 37065, 55280, 32659, 24707, 82200, 12586, 7094, 5492
Forsyth County, North Carolina, 37067, 361684, 45471, 159748, 151100, 88917, 61780, 27137
Franklin County, North Carolina, 37069, 62296, 42685, 26788, 129500, 17523, 10915, 6608
Gaston County, North Carolina, 37071, 209807, 42429, 89702, 125100, 52638, 33773, 18865
Gates County, North Carolina, 37073, 11724, 49258, 5225, 144300, 3504, 2051, 1453
Graham County, North Carolina, 37075, 8700, 34805, 5930, 120700, 2683, 1089, 1594
Granville County, North Carolina, 37077, 58109, 50225, 23136, 142600, 14666, 10056, 4610
Greene County, North Carolina, 37079, 21328, 35777, 8152, 87700, 5026, 2608, 2418
Guilford County, North Carolina, 37081, 506763, 45651, 222057, 156100, 118976, 85678, 33298
Halifax County, North Carolina, 37083, 53407, 32245, 25719, 86600, 13524, 6903, 6621
Harnett County, North Carolina, 37085, 124320, 46353, 48676, 135400, 28139, 19057, 9082
Haywood County, North Carolina, 37087, 59170, 42257, 35086, 161300, 19030, 10386, 8644
Henderson County, North Carolina, 37089, 109719, 46448, 55199, 182300, 33454, 19464, 13990
Hertford County, North Carolina, 37091, 24368, 33008, 10564, 83000, 5668, 2833, 2835
Hoke County, North Carolina, 37093, 51075, 41542, 19529, 141500, 11234, 8050, 3184
Hyde County, North Carolina, 37095, 5693, 42897, 3406, 90600, 1593, 595, 998
Iredell County, North Carolina, 37097, 165066, 52306, 69904, 166300, 44390, 30875, 13515
Jackson County, North Carolina, 37099, 40812, 38015, 26322, 171900, 10786, 5486, 5300
Johnston County, North Carolina, 37101, 178396, 50512, 69430, 145500, 43871, 31667, 12204
Jones County, North Carolina, 37103, 10166, 34005, 4863, 93900, 2920, 1595, 1325
Lee County, North Carolina, 37105, 59418, 45608, 24208, 136900, 14145, 8670, 5475
Lenoir County, North Carolina, 37107, 58782, 34717, 27285, 92500, 14083, 7642, 6441
Lincoln County, North Carolina, 37109, 79578, 49215, 33864, 153200, 23191, 15509, 7682
McDowell County, North Carolina, 37111, 44961, 35965, 20893, 98400, 12165, 5895, 6270
Macon County, North Carolina, 37113, 33919, 39133, 25303, 165600, 11258, 5683, 5575
Madison County, North Carolina, 37115, 21027, 37904, 10672, 159900, 6198, 2876, 3322
Martin County, North Carolina, 37117, 23729, 35080, 11595, 85500, 6329, 2858, 3471
Mecklenburg County, North Carolina, 37119, 990288, 56854, 412598, 184800, 218311, 173531, 44780
Mitchell County, North Carolina, 37121, 15330, 37391, 8734, 141100, 4862, 2163, 2699
Montgomery County, North Carolina, 37123, 27601, 32500, 15994, 90900, 7443, 3346, 4097
Moore County, North Carolina, 37125, 91743, 50998, 44881, 199100, 27714, 16743, 10971
Nash County, North Carolina, 37127, 94722, 42713, 42387, 118600, 23632, 15292, 8340
New Hanover County, North Carolina, 37129, 213091, 50088, 104141, 214300, 50638, 35767, 14871
Northampton County, North Carolina, 37131, 21011, 30429, 11567, 82500, 5950, 2880, 3070
Onslow County, North Carolina, 37133, 183753, 46335, 74206, 154000, 33428, 23920, 9508
Orange County, North Carolina, 37135, 138644, 59290, 56297, 272600, 31331, 21485, 9846
Pamlico County, North Carolina, 37137, 12982, 43444, 7569, 150800, 3975, 2005, 1970
Pasquotank County, North Carolina, 37139, 40018, 45378, 16865, 158800, 9030, 5893, 3137
Pender County, North Carolina, 37141, 55166, 44828, 27071, 153400, 15490, 9882, 5608
Perquimans County, North Carolina, 37143, 13498, 44329, 7030, 165800, 4278, 2541, 1737
Person County, North Carolina, 37145, 39262, 42105, 18183, 115500, 11038, 6862, 4176
Pitt County, North Carolina, 37147, 173798, 41119, 76269, 135300, 35626, 23570, 12056
Polk County, North Carolina, 37149, 20327, 46528, 11450, 190700, 6512, 3320, 3192
Randolph County, North Carolina, 37151, 142370, 41947, 61221, 120700, 39612, 23791, 15821
Richmond County, North Carolina, 37153, 46046, 32687, 20943, 78600, 11579, 5605, 5974
Robeson County, North Carolina, 37155, 134871, 30608, 52454, 70200, 28886, 12481, 16405
Rockingham County, North Carolina, 37157, 92300, 38126, 43621, 106700, 25841, 15079, 10762
Rowan County, North Carolina, 37159, 138361, 43069, 60167, 128300, 34764, 21641, 13123
Rutherford County, North Carolina, 37161, 66865, 35630, 33860, 106600, 18870, 10069, 8801
Sampson County, North Carolina, 37163, 63873, 35490, 27166, 87600, 16478, 8140, 8338
Scotland County, North Carolina, 37165, 35932, 30958, 15173, 79100, 8196, 4395, 3801
Stanly County, North Carolina, 37167, 60586, 40910, 27216, 128200, 16815, 9953, 6862
Stokes County, North Carolina, 37169, 46661, 40696, 21836, 117400, 14696, 8698, 5998
Surry County, North Carolina, 37171, 73170, 36164, 33565, 115500, 21094, 11186, 9908
Swain County, North Carolina, 37173, 14163, 33931, 8769, 126700, 3888, 1613, 2275
Transylvania County, North Carolina, 37175, 32928, 45114, 19310, 192000, 10476, 5062, 5414
Tyrrell County, North Carolina, 37177, 4152, 32361, 2003, 98800, 1072, 546, 526
Union County, North Carolina, 37179, 213422, 65903, 75313, 197400, 56496, 43586, 12910
Vance County, North Carolina, 37181, 44829, 33316, 19990, 97900, 10411, 5847, 4564
Wake County, North Carolina, 37183, 976019, 67309, 392813, 234000, 234084, 185003, 49081
Warren County, North Carolina, 37185, 20468, 34254, 11750, 96400, 5483, 2870, 2613
Washington County, North Carolina, 37187, 12668, 34538, 6455, 82700, 3581, 1740, 1841
Watauga County, North Carolina, 37189, 52240, 37656, 32737, 231700, 11570, 6740, 4830
Wayne County, North Carolina, 37191, 124355, 40390, 53141, 110400, 28479, 16552, 11927
Wilkes County, North Carolina, 37193, 68946, 33232, 33017, 114800, 20385, 10105, 10280
Wilson County, North Carolina, 37195, 81581, 39847, 35671, 116300, 19213, 11830, 7383
Yadkin County, North Carolina, 37197, 37971, 37796, 17250, 124400, 11688, 6637, 5051
Yancey County, North Carolina, 37199, 17604, 37484, 11058, 140500, 5596, 2507, 3089
Adams County, North Dakota, 38001, 2341, 52118, 1378, 126100, 786, 319, 467
Barnes County, North Dakota, 38003, 11097, 53141, 5723, 97600, 3473, 1503, 1970
Benson County, North Dakota, 38005, 6794, 41296, 2983, 63600, 1463, 402, 1061
Billings County, North Dakota, 38007, 969, 70469, 519, 145300, 301, 107, 194
Bottineau County, North Dakota, 38009, 6634, 56349, 4342, 116800, 2257, 797, 1460
Bowman County, North Dakota, 38011, 3221, 66845, 1718, 135000, 1019, 413, 606
Burke County, North Dakota, 38013, 2208, 60096, 1333, 110100, 659, 168, 491
Burleigh County, North Dakota, 38015, 88223, 65254, 38716, 199200, 25896, 15517, 10379
Cass County, North Dakota, 38017, 162500, 53289, 73190, 172100, 35858, 24917, 10941
Cavalier County, North Dakota, 38019, 3890, 66806, 2324, 86700, 1498, 477, 1021
Dickey County, North Dakota, 38021, 5195, 53750, 2629, 92000, 1533, 594, 939
Divide County, North Dakota, 38023, 2314, 56042, 1488, 100400, 858, 176, 682
Dunn County, North Dakota, 38025, 4195, 69732, 2404, 146400, 1261, 452, 809
Eddy County, North Dakota, 38027, 2370, 48583, 1325, 68500, 785, 314, 471
Emmons County, North Dakota, 38029, 3463, 44051, 2108, 79900, 1289, 349, 940
Foster County, North Dakota, 38031, 3366, 55769, 1804, 96300, 1097, 462, 635
Golden Valley County, North Dakota, 38033, 1822, 40179, 978, 107000, 542, 187, 355
Grand Forks County, North Dakota, 38035, 68979, 48676, 30678, 160600, 14244, 8856, 5388
Grant County, North Dakota, 38037, 2362, 44559, 1716, 75100, 925, 278, 647
Griggs County, North Dakota, 38039, 2329, 48355, 1408, 83600, 765, 220, 545
Hettinger County, North Dakota, 38041, 2621, 52169, 1422, 95700, 906, 259, 647
Kidder County, North Dakota, 38043, 2430, 54559, 1683, 87600, 877, 339, 538
LaMoure County, North Dakota, 38045, 4113, 54821, 2251, 85200, 1444, 458, 986
Logan County, North Dakota, 38047, 1945, 51458, 1153, 71000, 733, 184, 549
McHenry County, North Dakota, 38049, 5817, 57386, 3036, 107700, 2135, 869, 1266
McIntosh County, North Dakota, 38051, 2759, 42277, 1855, 62800, 1059, 311, 748
McKenzie County, North Dakota, 38053, 9615, 72794, 3944, 198400, 1966, 716, 1250
McLean County, North Dakota, 38055, 9451, 55686, 5815, 130500, 3227, 1227, 2000
Mercer County, North Dakota, 38057, 8633, 72704, 4616, 136600, 3049, 1477, 1572
Morton County, North Dakota, 38059, 28985, 62418, 13268, 165500, 9308, 5713, 3595
Mountrail County, North Dakota, 38061, 9253, 68188, 4576, 132300, 2234, 987, 1247
Nelson County, North Dakota, 38063, 3048, 51085, 1931, 73200, 1178, 346, 832
Oliver County, North Dakota, 38065, 1819, 60278, 975, 120300, 642, 258, 384
Pembina County, North Dakota, 38067, 7206, 53504, 3871, 76900, 2567, 1000, 1567
Pierce County, North Dakota, 38069, 4395, 42563, 2282, 97900, 1478, 568, 910
Ramsey County, North Dakota, 38071, 11566, 50841, 5747, 102400, 3179, 1598, 1581
Ransom County, North Dakota, 38073, 5453, 56500, 2670, 103600, 1596, 724, 872
Renville County, North Dakota, 38075, 2562, 65125, 1253, 118000, 796, 368, 428
Richland County, North Dakota, 38077, 16317, 55390, 7619, 102000, 4722, 2478, 2244
Rolette County, North Dakota, 38079, 14498, 33277, 5476, 69000, 3234, 714, 2520
Sargent County, North Dakota, 38081, 3874, 57125, 2041, 77900, 1305, 499, 806
Sheridan County, North Dakota, 38083, 1337, 48102, 843, 69600, 532, 124, 408
Sioux County, North Dakota, 38085, 4380, 38068, 1324, 66200, 453, 123, 330
Slope County, North Dakota, 38087, 673, 55000, 461, 101100, 276, 68, 208
Stark County, North Dakota, 38089, 28628, 72099, 12741, 206200, 7819, 4445, 3374
Steele County, North Dakota, 38091, 1979, 55833, 1248, 74900, 734, 226, 508
Stutsman County, North Dakota, 38093, 21076, 52359, 10030, 111200, 6042, 2994, 3048
Towner County, North Dakota, 38095, 2294, 56625, 1382, 70400, 781, 249, 532
Traill County, North Dakota, 38097, 8077, 54960, 3813, 105600, 2400, 1207, 1193
Walsh County, North Dakota, 38099, 11005, 49411, 5571, 75400, 3663, 1453, 2210
Ward County, North Dakota, 38101, 67736, 61393, 30210, 189500, 16030, 9577, 6453
Wells County, North Dakota, 38103, 4204, 48098, 2508, 73700, 1576, 509, 1067
Williams County, North Dakota, 38105, 29619, 88013, 14683, 201400, 7735, 3949, 3786
Adams County, Ohio, 39001, 28229, 35560, 12848, 87900, 7495, 3986, 3509
Allen County, Ohio, 39003, 105196, 44103, 44859, 105400, 26883, 16227, 10656
Ashland County, Ohio, 39005, 53189, 48003, 22104, 120800, 14680, 9049, 5631
Ashtabula County, Ohio, 39007, 99777, 40544, 45907, 106000, 27701, 16342, 11359
Athens County, Ohio, 39009, 64974, 33872, 26260, 117700, 12662, 6729, 5933
Auglaize County, Ohio, 39011, 45873, 54274, 19641, 133300, 13493, 8147, 5346
Belmont County, Ohio, 39013, 69560, 43833, 32220, 91700, 20719, 10519, 10200
Brown County, Ohio, 39015, 44247, 45568, 19349, 113800, 12614, 7833, 4781
Butler County, Ohio, 39017, 372538, 57540, 149016, 157200, 93510, 66719, 26791
Carroll County, Ohio, 39019, 28361, 47075, 13610, 112200, 8593, 4812, 3781
Champaign County, Ohio, 39021, 39393, 50974, 16714, 123200, 11195, 6984, 4211
Clark County, Ohio, 39023, 136827, 43625, 61241, 103600, 36310, 22221, 14089
Clermont County, Ohio, 39025, 200285, 60805, 81668, 155500, 55099, 38462, 16637
Clinton County, Ohio, 39027, 41892, 46787, 18063, 120000, 10354, 6782, 3572
Columbiana County, Ohio, 39029, 105987, 44497, 46777, 101100, 29930, 16627, 13303
Coshocton County, Ohio, 39031, 36724, 41701, 16408, 96500, 10672, 5878, 4794
Crawford County, Ohio, 39033, 42725, 40795, 20052, 86700, 12208, 6461, 5747
Cuyahoga County, Ohio, 39035, 1263189, 44190, 619303, 121800, 317310, 205776, 111534
Darke County, Ohio, 39037, 52356, 44632, 22723, 109900, 15053, 8465, 6588
Defiance County, Ohio, 39039, 38669, 50663, 16709, 108900, 11451, 7045, 4406
Delaware County, Ohio, 39041, 185433, 91955, 68668, 256800, 53523, 41822, 11701
Erie County, Ohio, 39043, 76141, 48011, 37739, 131400, 21798, 13561, 8237
Fairfield County, Ohio, 39045, 149112, 60567, 59367, 163100, 38803, 27665, 11138
Fayette County, Ohio, 39047, 28769, 40503, 12668, 107400, 6963, 4272, 2691
Franklin County, Ohio, 39049, 1215761, 52341, 536811, 150600, 258868, 194622, 64246
Fulton County, Ohio, 39051, 42485, 55120, 17368, 129500, 12746, 8421, 4325
Gallia County, Ohio, 39053, 30565, 37319, 13820, 94900, 8880, 4018, 4862
Geauga County, Ohio, 39055, 93874, 72430, 36683, 218800, 29605, 20072, 9533
Greene County, Ohio, 39057, 164192, 60113, 68953, 159400, 43163, 29139, 14024
Guernsey County, Ohio, 39059, 39626, 40930, 19091, 95600, 11363, 6287, 5076
Hamilton County, Ohio, 39061, 804194, 49013, 377126, 142000, 193184, 135280, 57904
Hancock County, Ohio, 39063, 75428, 50895, 33270, 127100, 21951, 14238, 7713
Hardin County, Ohio, 39065, 31736, 42703, 13108, 94000, 8185, 4781, 3404
Harrison County, Ohio, 39067, 15633, 43173, 8115, 85400, 4994, 2616, 2378
Henry County, Ohio, 39069, 28015, 53835, 11933, 111000, 8818, 5491, 3327
Highland County, Ohio, 39071, 43170, 39858, 19256, 103500, 11785, 7422, 4363
Hocking County, Ohio, 39073, 28914, 42170, 13351, 110600, 8465, 5058, 3407
Holmes County, Ohio, 39075, 43436, 51996, 13607, 161100, 9661, 5512, 4149
Huron County, Ohio, 39077, 58937, 48745, 25134, 116100, 15929, 10013, 5916
Jackson County, Ohio, 39079, 32854, 39460, 14557, 91200, 8791, 4941, 3850
Jefferson County, Ohio, 39081, 68053, 41942, 32604, 86200, 19796, 9886, 9910
Knox County, Ohio, 39083, 61004, 48533, 25388, 132500, 16124, 10374, 5750
Lake County, Ohio, 39085, 229437, 58029, 101632, 147900, 70102, 46954, 23148
Lawrence County, Ohio, 39087, 61827, 42874, 27418, 98900, 17472, 8896, 8576
Licking County, Ohio, 39089, 168693, 56549, 69779, 152200, 46298, 32516, 13782
Logan County, Ohio, 39091, 45484, 49783, 23163, 119400, 13725, 8405, 5320
Lorain County, Ohio, 39093, 303152, 52457, 128268, 137400, 83591, 55021, 28570
Lucas County, Ohio, 39095, 436261, 41777, 202269, 104200, 108258, 70700, 37558
Madison County, Ohio, 39097, 43456, 57406, 15913, 149200, 10482, 7305, 3177
Mahoning County, Ohio, 39099, 234550, 41375, 111465, 97400, 66710, 38873, 27837
Marion County, Ohio, 39101, 65943, 42966, 27829, 96400, 16618, 9662, 6956
Medina County, Ohio, 39103, 174831, 66952, 70239, 179500, 52373, 37056, 15317
Meigs County, Ohio, 39105, 23473, 37813, 11076, 84900, 7317, 3434, 3883
Mercer County, Ohio, 39107, 40863, 53099, 17645, 130200, 12190, 6746, 5444
Miami County, Ohio, 39109, 103517, 51569, 44266, 136800, 28906, 19579, 9327
Monroe County, Ohio, 39111, 14547, 41528, 7501, 92200, 4687, 1620, 3067
Montgomery County, Ohio, 39113, 533763, 43829, 254415, 109900, 135689, 89319, 46370
Morgan County, Ohio, 39115, 14913, 37067, 7849, 88300, 4715, 2412, 2303
Morrow County, Ohio, 39117, 34996, 51993, 14123, 132800, 10298, 6589, 3709
Muskingum County, Ohio, 39119, 86016, 41130, 37854, 108600, 22899, 13616, 9283
Noble County, Ohio, 39121, 14508, 41708, 6036, 87100, 4074, 1679, 2395
Ottawa County, Ohio, 39123, 41162, 53914, 27967, 138800, 13775, 8251, 5524
Paulding County, Ohio, 39125, 19165, 45550, 8692, 91900, 6010, 3467, 2543
Perry County, Ohio, 39127, 36025, 42017, 15161, 91800, 10093, 6042, 4051
Pickaway County, Ohio, 39129, 56515, 57439, 21182, 147700, 14363, 9757, 4606
Pike County, Ohio, 39131, 28396, 40283, 12530, 95000, 7463, 4099, 3364
Portage County, Ohio, 39133, 161897, 52552, 67897, 150900, 41928, 27522, 14406
Preble County, Ohio, 39135, 41682, 47818, 17851, 112700, 12375, 7816, 4559
Putnam County, Ohio, 39137, 34184, 60524, 13768, 138900, 10766, 6112, 4654
Richland County, Ohio, 39139, 122312, 41877, 54353, 102500, 33004, 19137, 13867
Ross County, Ohio, 39141, 77334, 43345, 31917, 110300, 20275, 12335, 7940
Sandusky County, Ohio, 39143, 60187, 47209, 26257, 110100, 17523, 10758, 6765
Scioto County, Ohio, 39145, 78017, 35903, 34084, 90200, 20345, 10009, 10336
Seneca County, Ohio, 39147, 55929, 45444, 23959, 96900, 15358, 8939, 6419
Shelby County, Ohio, 39149, 49067, 54550, 20201, 130000, 13138, 8346, 4792
Stark County, Ohio, 39151, 374979, 47137, 165462, 122900, 103621, 66454, 37167
Summit County, Ohio, 39153, 541847, 50765, 245237, 133500, 146424, 97887, 48537
Trumbull County, Ohio, 39155, 206373, 43073, 95669, 97000, 61531, 34954, 26577
Tuscarawas County, Ohio, 39157, 92697, 45310, 40007, 111100, 25820, 15136, 10684
Union County, Ohio, 39159, 53470, 67382, 19815, 171200, 14277, 10903, 3374
Van Wert County, Ohio, 39161, 28576, 48060, 12672, 95800, 8594, 4728, 3866
Vinton County, Ohio, 39163, 13234, 40680, 6223, 81000, 3848, 2172, 1676
Warren County, Ohio, 39165, 219916, 74379, 82922, 190900, 60511, 46086, 14425
Washington County, Ohio, 39167, 61351, 43509, 28124, 110700, 18837, 9324, 9513
Wayne County, Ohio, 39169, 115371, 50383, 45939, 135700, 31355, 19131, 12224
Williams County, Ohio, 39171, 37386, 42492, 16564, 95800, 11305, 6858, 4447
Wood County, Ohio, 39173, 128885, 53577, 53726, 146300, 33440, 22206, 11234
Wyandot County, Ohio, 39175, 22467, 47555, 9894, 106200, 6734, 3972, 2762
Adair County, Oklahoma, 40001, 22236, 33404, 9212, 76600, 5605, 2386, 3219
Alfalfa County, Oklahoma, 40003, 5755, 50156, 2753, 64600, 1575, 541, 1034
Atoka County, Oklahoma, 40005, 13906, 36661, 6353, 85400, 3846, 1704, 2142
Beaver County, Oklahoma, 40007, 5530, 52090, 2663, 89300, 1594, 530, 1064
Beckham County, Oklahoma, 40009, 23300, 48601, 9831, 122400, 4815, 2454, 2361
Blaine County, Oklahoma, 40011, 9810, 41972, 4723, 77900, 2688, 981, 1707
Bryan County, Oklahoma, 40013, 44003, 38847, 19826, 90100, 10749, 5123, 5626
Caddo County, Oklahoma, 40015, 29495, 40674, 13164, 78400, 7156, 2795, 4361
Canadian County, Oklahoma, 40017, 126193, 64505, 46753, 144600, 33128, 22754, 10374
Carter County, Oklahoma, 40019, 48442, 44531, 21408, 97000, 12493, 6329, 6164
Cherokee County, Oklahoma, 40021, 48097, 38694, 21639, 108100, 10912, 5672, 5240
Choctaw County, Oklahoma, 40023, 15120, 30617, 7533, 80900, 4201, 1806, 2395
Cimarron County, Oklahoma, 40025, 2341, 46680, 1580, 59500, 741, 205, 536
Cleveland County, Oklahoma, 40027, 268614, 56452, 108874, 146100, 65881, 44999, 20882
Coal County, Oklahoma, 40029, 5812, 38243, 2798, 80100, 1658, 637, 1021
Comanche County, Oklahoma, 40031, 125531, 46241, 51481, 115800, 23887, 14934, 8953
Cotton County, Oklahoma, 40033, 6112, 46361, 3019, 79900, 1838, 958, 880
Craig County, Oklahoma, 40035, 14744, 38876, 6709, 90600, 4091, 2041, 2050
Creek County, Oklahoma, 40037, 70761, 45016, 29950, 105000, 19657, 10441, 9216
Custer County, Oklahoma, 40039, 28978, 46125, 12369, 119000, 6189, 3092, 3097
Delaware County, Oklahoma, 40041, 41409, 37942, 24869, 109000, 12525, 6162, 6363
Dewey County, Oklahoma, 40043, 4863, 50904, 2440, 84200, 1350, 448, 902
Ellis County, Oklahoma, 40045, 4121, 50855, 2267, 81800, 1318, 439, 879
Garfield County, Oklahoma, 40047, 62192, 48238, 26856, 96900, 15938, 8355, 7583
Garvin County, Oklahoma, 40049, 27455, 40524, 12815, 88000, 7310, 3474, 3836
Grady County, Oklahoma, 40051, 53612, 52279, 22437, 111200, 14860, 8078, 6782
Grant County, Oklahoma, 40053, 4517, 50250, 2465, 73200, 1486, 567, 919
Greer County, Oklahoma, 40055, 6117, 40125, 2736, 61600, 1443, 528, 915
Harmon County, Oklahoma, 40057, 2866, 31250, 1540, 51300, 813, 345, 468
Harper County, Oklahoma, 40059, 3766, 48359, 1896, 74100, 1160, 364, 796
Haskell County, Oklahoma, 40061, 12850, 35252, 6046, 80100, 3590, 1390, 2200
Hughes County, Oklahoma, 40063, 13785, 35563, 6241, 67600, 3352, 1209, 2143
Jackson County, Oklahoma, 40065, 26056, 41560, 12145, 90300, 5999, 2943, 3056
Jefferson County, Oklahoma, 40067, 6333, 33449, 3403, 56600, 1770, 695, 1075
Johnston County, Oklahoma, 40069, 11022, 38776, 5136, 78200, 3026, 1544, 1482
Kay County, Oklahoma, 40071, 45587, 42134, 21626, 78800, 12488, 5933, 6555
Kingfisher County, Oklahoma, 40073, 15302, 60034, 6454, 122100, 4384, 2105, 2279
Kiowa County, Oklahoma, 40075, 9302, 39909, 5183, 60300, 2736, 972, 1764
Latimer County, Oklahoma, 40077, 10774, 39205, 4986, 80500, 2833, 1195, 1638
Le Flore County, Oklahoma, 40079, 49899, 36490, 21652, 81600, 13322, 6277, 7045
Lincoln County, Oklahoma, 40081, 34504, 45149, 15222, 99800, 10220, 5410, 4810
Logan County, Oklahoma, 40083, 44493, 55299, 17231, 142900, 11934, 7212, 4722
Love County, Oklahoma, 40085, 9663, 44549, 4528, 89000, 2445, 1008, 1437
McClain County, Oklahoma, 40087, 36512, 56088, 14514, 152600, 10623, 6127, 4496
McCurtain County, Oklahoma, 40089, 33143, 32324, 15571, 73700, 8902, 3150, 5752
McIntosh County, Oklahoma, 40091, 20280, 36011, 13408, 90100, 6554, 2573, 3981
Major County, Oklahoma, 40093, 7700, 51571, 3651, 89300, 2273, 896, 1377
Marshall County, Oklahoma, 40095, 16014, 40475, 10022, 85700, 4563, 1872, 2691
Mayes County, Oklahoma, 40097, 41007, 42071, 19231, 104000, 11531, 5831, 5700
Murray County, Oklahoma, 40099, 13733, 47077, 6774, 88500, 3582, 1519, 2063
Muskogee County, Oklahoma, 40101, 70224, 39984, 30920, 91500, 17650, 9772, 7878
Noble County, Oklahoma, 40103, 11506, 48285, 5329, 87500, 3513, 1890, 1623
Nowata County, Oklahoma, 40105, 10555, 39875, 4817, 76300, 3149, 1499, 1650
Okfuskee County, Oklahoma, 40107, 12248, 36216, 5297, 76400, 3000, 1291, 1709
Oklahoma County, Oklahoma, 40109, 754480, 47437, 326985, 133400, 171014, 108406, 62608
Okmulgee County, Oklahoma, 40111, 39446, 38843, 17825, 78800, 10416, 5103, 5313
Osage County, Oklahoma, 40113, 48054, 45443, 21381, 100000, 14203, 7180, 7023
Ottawa County, Oklahoma, 40115, 32085, 36347, 14067, 82600, 8433, 4111, 4322
Pawnee County, Oklahoma, 40117, 16499, 45765, 7738, 85100, 4781, 2237, 2544
Payne County, Oklahoma, 40119, 79423, 37667, 34700, 135600, 15152, 8574, 6578
Pittsburg County, Oklahoma, 40121, 44961, 42576, 22838, 94500, 13099, 6459, 6640
Pontotoc County, Oklahoma, 40123, 38055, 43261, 16696, 107800, 9355, 4927, 4428
Pottawatomie County, Oklahoma, 40125, 71136, 44688, 29538, 102700, 17892, 9708, 8184
Pushmataha County, Oklahoma, 40127, 11226, 32445, 6122, 72600, 3530, 1298, 2232
Roger Mills County, Oklahoma, 40129, 3780, 50739, 1907, 86100, 974, 324, 650
Rogers County, Oklahoma, 40131, 89190, 58139, 36071, 144600, 26320, 16613, 9707
Seminole County, Oklahoma, 40133, 25481, 36068, 11662, 69200, 6671, 3079, 3592
Sequoyah County, Oklahoma, 40135, 41464, 35736, 18800, 89600, 11116, 5322, 5794
Stephens County, Oklahoma, 40137, 44806, 43781, 20682, 98400, 12567, 6441, 6126
Texas County, Oklahoma, 40139, 21588, 50242, 8181, 92700, 4454, 2200, 2254
Tillman County, Oklahoma, 40141, 7715, 37759, 4060, 56600, 2234, 858, 1376
Tulsa County, Oklahoma, 40143, 623335, 49759, 274891, 138500, 146793, 96481, 50312
Wagoner County, Oklahoma, 40145, 75391, 55715, 30486, 141700, 21888, 14027, 7861
Washington County, Oklahoma, 40147, 51760, 50023, 23616, 111300, 15193, 8431, 6762
Washita County, Oklahoma, 40149, 11649, 49632, 5469, 77600, 3339, 1444, 1895
Woods County, Oklahoma, 40151, 9033, 55315, 4457, 88200, 2371, 914, 1457
Woodward County, Oklahoma, 40153, 20986, 55300, 8909, 115400, 5243, 2657, 2586
Baker County, Oregon, 41001, 16052, 41098, 8822, 146600, 4730, 2419, 2311
Benton County, Oregon, 41003, 86495, 49802, 36992, 269700, 19470, 11933, 7537
Clackamas County, Oregon, 41005, 389438, 65965, 159754, 301000, 102040, 72601, 29439
Clatsop County, Oregon, 41007, 37382, 46408, 21779, 246500, 9546, 6085, 3461
Columbia County, Oregon, 41009, 49389, 53179, 20692, 206100, 13788, 9251, 4537
Coos County, Oregon, 41011, 62775, 38605, 30482, 170500, 16831, 8983, 7848
Crook County, Oregon, 41013, 20956, 37106, 10294, 166900, 6233, 3829, 2404
Curry County, Oregon, 41015, 22338, 40884, 12622, 218200, 6841, 3248, 3593
Deschutes County, Oregon, 41017, 166622, 51223, 81773, 253400, 42919, 29653, 13266
Douglas County, Oregon, 41019, 107194, 41312, 49018, 169700, 29523, 16930, 12593
Gilliam County, Oregon, 41021, 1883, 44293, 1073, 117900, 506, 257, 249
Grant County, Oregon, 41023, 7276, 38046, 4320, 143000, 2276, 1047, 1229
Harney County, Oregon, 41025, 7229, 37580, 3811, 102000, 2096, 983, 1113
Hood River County, Oregon, 41027, 22749, 55827, 9458, 321300, 5313, 3244, 2069
Jackson County, Oregon, 41029, 208363, 44028, 91782, 218100, 51746, 31974, 19772
Jefferson County, Oregon, 41031, 22061, 46366, 9789, 149100, 5136, 3270, 1866
Josephine County, Oregon, 41033, 83409, 37665, 38028, 215900, 22919, 13311, 9608
Klamath County, Oregon, 41035, 65972, 40336, 32825, 151500, 17626, 10640, 6986
Lake County, Oregon, 41037, 7842, 32369, 4411, 129100, 2114, 986, 1128
Lane County, Oregon, 41039, 357060, 44103, 157510, 215300, 85785, 55897, 29888
Lincoln County, Oregon, 41041, 46347, 42101, 30703, 219100, 13125, 7283, 5842
Linn County, Oregon, 41043, 118971, 45644, 49005, 170300, 28988, 18471, 10517
Malheur County, Oregon, 41045, 30551, 35418, 11629, 127000, 6145, 3327, 2818
Marion County, Oregon, 41047, 323259, 48432, 122315, 186700, 68134, 46244, 21890
Morrow County, Oregon, 41049, 11204, 50918, 4449, 121800, 2635, 1532, 1103
Multnomah County, Oregon, 41051, 768418, 54102, 329504, 278300, 167110, 123886, 43224
Polk County, Oregon, 41053, 77264, 52821, 30651, 209200, 18292, 12426, 5866
Sherman County, Oregon, 41055, 1795, 38362, 938, 140500, 495, 178, 317
Tillamook County, Oregon, 41057, 25430, 42581, 18474, 222900, 7311, 4227, 3084
Umatilla County, Oregon, 41059, 76738, 48101, 29741, 144000, 16791, 10110, 6681
Union County, Oregon, 41061, 25745, 43822, 11513, 163200, 6467, 3841, 2626
Wallowa County, Oregon, 41063, 6857, 40581, 4088, 204500, 2078, 1056, 1022
Wasco County, Oregon, 41065, 25492, 43422, 11423, 174800, 6263, 4041, 2222
Washington County, Oregon, 41067, 556210, 66754, 217085, 285100, 124690, 94691, 29999
Wheeler County, Oregon, 41069, 1348, 33487, 935, 113800, 472, 190, 282
Yamhill County, Oregon, 41071, 101119, 53423, 37495, 220800, 23203, 16192, 7011
Adams County, Pennsylvania, 42001, 101767, 60356, 41235, 193100, 29536, 19108, 10428
Allegheny County, Pennsylvania, 42003, 1231145, 53040, 589681, 129600, 343306, 210864, 132442
Armstrong County, Pennsylvania, 42005, 67979, 44942, 32411, 96000, 21411, 10789, 10622
Beaver County, Pennsylvania, 42007, 169785, 50581, 78292, 120100, 51134, 29392, 21742
Bedford County, Pennsylvania, 42009, 49086, 45930, 24012, 122700, 15930, 7945, 7985
Berks County, Pennsylvania, 42011, 413965, 55936, 164853, 168200, 110223, 71966, 38257
Blair County, Pennsylvania, 42013, 126448, 43981, 56109, 110600, 36617, 19818, 16799
Bradford County, Pennsylvania, 42015, 62228, 48987, 30102, 135900, 18168, 8711, 9457
Bucks County, Pennsylvania, 42017, 626583, 77568, 246515, 308800, 178113, 122503, 55610
Butler County, Pennsylvania, 42019, 185689, 60934, 79529, 178100, 57196, 35116, 22080
Cambria County, Pennsylvania, 42021, 139381, 42107, 65413, 87100, 42440, 21006, 21434
Cameron County, Pennsylvania, 42023, 4869, 39897, 4410, 70600, 1525, 742, 783
Carbon County, Pennsylvania, 42025, 64634, 49973, 34400, 144700, 20158, 12081, 8077
Centre County, Pennsylvania, 42027, 157823, 52186, 64489, 197200, 34606, 21112, 13494
Chester County, Pennsylvania, 42029, 509797, 85976, 194892, 325800, 139807, 99596, 40211
Clarion County, Pennsylvania, 42031, 39454, 42536, 19965, 107100, 10963, 5096, 5867
Clearfield County, Pennsylvania, 42033, 81343, 42257, 38614, 87300, 24555, 11573, 12982
Clinton County, Pennsylvania, 42035, 39614, 45078, 19035, 117400, 10549, 5710, 4839
Columbia County, Pennsylvania, 42037, 66912, 45374, 29597, 140600, 18440, 10071, 8369
Crawford County, Pennsylvania, 42039, 87343, 44579, 44442, 104800, 25422, 13674, 11748
Cumberland County, Pennsylvania, 42041, 241427, 61820, 102046, 188400, 67813, 44341, 23472
Dauphin County, Pennsylvania, 42043, 271094, 53754, 121546, 159200, 69586, 45488, 24098
Delaware County, Pennsylvania, 42045, 561683, 65123, 222249, 232700, 142548, 96699, 45849
Elk County, Pennsylvania, 42047, 31370, 46671, 17535, 90700, 10344, 4566, 5778
Erie County, Pennsylvania, 42049, 279858, 45971, 119827, 118200, 72273, 43228, 29045
Fayette County, Pennsylvania, 42051, 134851, 39636, 62878, 88900, 38729, 18316, 20413
Forest County, Pennsylvania, 42053, 7581, 35533, 8698, 84400, 1632, 606, 1026
Franklin County, Pennsylvania, 42055, 152285, 53916, 63947, 173400, 42014, 25528, 16486
Fulton County, Pennsylvania, 42057, 14694, 48311, 7104, 153200, 4714, 2358, 2356
Greene County, Pennsylvania, 42059, 37938, 46661, 16443, 97400, 10518, 4893, 5625
Huntingdon County, Pennsylvania, 42061, 45906, 44396, 22411, 119000, 13118, 6911, 6207
Indiana County, Pennsylvania, 42063, 87895, 45195, 38457, 107000, 24112, 12040, 12072
Jefferson County, Pennsylvania, 42065, 44756, 42903, 22392, 90300, 13802, 6770, 7032
Juniata County, Pennsylvania, 42067, 24829, 47398, 10982, 141700, 7078, 3599, 3479
Lackawanna County, Pennsylvania, 42069, 213459, 46271, 97028, 144800, 56646, 31913, 24733
Lancaster County, Pennsylvania, 42071, 530216, 57721, 205587, 189200, 134548, 86215, 48333
Lawrence County, Pennsylvania, 42073, 89162, 44571, 40830, 97300, 26929, 14434, 12495
Lebanon County, Pennsylvania, 42075, 135776, 55499, 56017, 163800, 36836, 22478, 14358
Lehigh County, Pennsylvania, 42077, 356756, 56117, 143313, 191700, 89178, 59120, 30058
Luzerne County, Pennsylvania, 42079, 320095, 45897, 148441, 122700, 87053, 49361, 37692
Lycoming County, Pennsylvania, 42081, 116656, 47313, 52641, 138500, 32187, 18737, 13450
McKean County, Pennsylvania, 42083, 42884, 43965, 21083, 76200, 12832, 6921, 5911
Mercer County, Pennsylvania, 42085, 115320, 44156, 51662, 107900, 33564, 17997, 15567
Mifflin County, Pennsylvania, 42087, 46675, 41288, 21527, 97800, 13178, 7004, 6174
Monroe County, Pennsylvania, 42089, 167881, 57365, 80632, 174500, 44899, 31942, 12957
Montgomery County, Pennsylvania, 42091, 812970, 80675, 327146, 292300, 223952, 157600, 66352
Montour County, Pennsylvania, 42093, 18508, 54648, 8027, 163400, 5346, 2818, 2528
Northampton County, Pennsylvania, 42095, 299616, 60972, 120997, 206100, 81074, 54934, 26140
Northumberland County, Pennsylvania, 42097, 94006, 42406, 44965, 104300, 28038, 14418, 13620
Perry County, Pennsylvania, 42099, 45677, 57177, 20513, 159900, 14254, 8760, 5494
Philadelphia County, Pennsylvania, 42101, 1555072, 38253, 670229, 145300, 305884, 184093, 121791
Pike County, Pennsylvania, 42103, 56632, 60180, 38513, 183200, 17720, 12211, 5509
Potter County, Pennsylvania, 42105, 17377, 40654, 12848, 101200, 5140, 2485, 2655
Schuylkill County, Pennsylvania, 42107, 146360, 45535, 69143, 93000, 43867, 22168, 21699
Snyder County, Pennsylvania, 42109, 40046, 49917, 16104, 144700, 10776, 6006, 4770
Somerset County, Pennsylvania, 42111, 76617, 44587, 38004, 98800, 23288, 11623, 11665
Sullivan County, Pennsylvania, 42113, 6381, 44189, 6311, 145800, 2222, 1064, 1158
Susquehanna County, Pennsylvania, 42115, 42369, 50477, 22997, 150700, 13421, 6991, 6430
Tioga County, Pennsylvania, 42117, 42284, 46494, 21441, 124700, 12346, 6212, 6134
Union County, Pennsylvania, 42119, 44958, 49803, 17074, 160200, 10670, 6192, 4478
Venango County, Pennsylvania, 42121, 53906, 43644, 27309, 81200, 16883, 8380, 8503
Warren County, Pennsylvania, 42123, 40962, 44020, 23428, 89700, 13113, 6460, 6653
Washington County, Pennsylvania, 42125, 208226, 56450, 93643, 152400, 63463, 36990, 26473
Wayne County, Pennsylvania, 42127, 51642, 49919, 31847, 179000, 15481, 8547, 6934
Westmoreland County, Pennsylvania, 42129, 361251, 52247, 168250, 138500, 115868, 65426, 50442
Wyoming County, Pennsylvania, 42131, 28147, 51004, 13313, 159500, 8485, 4719, 3766
York County, Pennsylvania, 42133, 439660, 58269, 180237, 168400, 124269, 83012, 41257
Bristol County, Rhode Island, 44001, 49176, 72458, 20801, 330100, 13682, 9229, 4453
Kent County, Rhode Island, 44003, 164958, 64383, 73631, 208500, 48218, 34371, 13847
Newport County, Rhode Island, 44005, 82663, 69526, 41856, 349200, 21571, 14277, 7294
Providence County, Rhode Island, 44007, 630459, 49743, 263890, 211200, 127215, 90263, 36952
Washington County, Rhode Island, 44009, 126405, 72807, 62722, 311600, 36223, 25301, 10922
Abbeville County, South Carolina, 45001, 24997, 34799, 12008, 88300, 7571, 3443, 4128
Aiken County, South Carolina, 45003, 163908, 45759, 73649, 128800, 47057, 26655, 20402
Allendale County, South Carolina, 45005, 9838, 25327, 4448, 56300, 2139, 645, 1494
Anderson County, South Carolina, 45007, 191215, 42143, 85296, 128100, 53216, 30977, 22239
Bamberg County, South Carolina, 45009, 15432, 31314, 7646, 63900, 4480, 1649, 2831
Barnwell County, South Carolina, 45011, 22098, 34336, 10411, 74100, 6086, 2488, 3598
Beaufort County, South Carolina, 45013, 171420, 57048, 93858, 274700, 46204, 28284, 17920
Berkeley County, South Carolina, 45015, 193613, 52506, 76503, 153500, 48237, 32506, 15731
Calhoun County, South Carolina, 45017, 14958, 43531, 7313, 100100, 4672, 2434, 2238
Charleston County, South Carolina, 45019, 372904, 53437, 175607, 243200, 89750, 59633, 30117
Cherokee County, South Carolina, 45021, 55863, 35389, 23993, 86500, 13941, 6023, 7918
Chester County, South Carolina, 45023, 32556, 31914, 14644, 86700, 8954, 4357, 4597
Chesterfield County, South Carolina, 45025, 46192, 32083, 21328, 77600, 12600, 5443, 7157
Clarendon County, South Carolina, 45027, 34178, 33162, 17402, 88500, 9629, 4428, 5201
Colleton County, South Carolina, 45029, 38004, 32804, 19749, 86000, 10844, 5171, 5673
Darlington County, South Carolina, 45031, 67922, 35409, 30244, 86800, 17885, 9049, 8836
Dillon County, South Carolina, 45033, 31435, 28938, 13619, 63500, 7569, 3432, 4137
Dorchester County, South Carolina, 45035, 145715, 54901, 57003, 168000, 36012, 25279, 10733
Edgefield County, South Carolina, 45037, 26466, 46637, 10608, 114900, 6900, 3964, 2936
Fairfield County, South Carolina, 45039, 23108, 36004, 11661, 97700, 6537, 3064, 3473
Florence County, South Carolina, 45041, 138330, 42080, 59011, 122200, 34346, 20158, 14188
Georgetown County, South Carolina, 45043, 60572, 42835, 33930, 159600, 18106, 8784, 9322
Greenville County, South Carolina, 45045, 474903, 50540, 199369, 156200, 118621, 78815, 39806
Greenwood County, South Carolina, 45047, 69771, 37060, 31103, 104900, 17437, 10300, 7137
Hampton County, South Carolina, 45049, 20473, 31410, 9058, 76400, 5658, 2284, 3374
Horry County, South Carolina, 45051, 290730, 43299, 191102, 159700, 81966, 47506, 34460
Jasper County, South Carolina, 45053, 26549, 37141, 10729, 99300, 6431, 3273, 3158
Kershaw County, South Carolina, 45055, 62722, 43622, 27896, 117600, 19055, 10764, 8291
Lancaster County, South Carolina, 45057, 81263, 44016, 33464, 150200, 22589, 13347, 9242
Laurens County, South Carolina, 45059, 66389, 38515, 30630, 83900, 18002, 8787, 9215
Lee County, South Carolina, 45061, 18461, 30954, 7705, 69800, 4720, 1973, 2747
Lexington County, South Carolina, 45063, 273843, 53857, 117446, 140500, 78476, 52148, 26328
McCormick County, South Carolina, 45065, 9895, 38712, 5456, 109400, 3076, 1405, 1671
Marion County, South Carolina, 45067, 32167, 29874, 14834, 75000, 8326, 3822, 4504
Marlboro County, South Carolina, 45069, 27993, 30767, 11983, 60200, 6532, 2603, 3929
Newberry County, South Carolina, 45071, 37690, 40127, 17954, 100800, 10462, 5165, 5297
Oconee County, South Carolina, 45073, 74949, 41237, 39020, 147000, 22644, 11387, 11257
Orangeburg County, South Carolina, 45075, 90575, 34218, 42237, 87600, 23085, 10518, 12567
Pickens County, South Carolina, 45077, 120124, 41459, 51731, 123000, 30915, 17669, 13246
Richland County, South Carolina, 45079, 397899, 49131, 165671, 149700, 85975, 61219, 24756
Saluda County, South Carolina, 45081, 20000, 38827, 9268, 92700, 5071, 2244, 2827
Spartanburg County, South Carolina, 45083, 291240, 43907, 123931, 123800, 75378, 46574, 28804
Sumter County, South Carolina, 45085, 107777, 41332, 46698, 107100, 26485, 15972, 10513
Union County, South Carolina, 45087, 28125, 34033, 14049, 72600, 8421, 3872, 4549
Williamsburg County, South Carolina, 45089, 33238, 28297, 15220, 68300, 8738, 3723, 5015
York County, South Carolina, 45091, 240076, 54117, 97834, 160100, 64200, 45658, 18542
Aurora County, South Dakota, 46003, 2729, 48750, 1361, 69400, 907, 369, 538
Beadle County, South Dakota, 46005, 18168, 46267, 8358, 96500, 4933, 2624, 2309
Bennett County, South Dakota, 46007, 3438, 42171, 1217, 56300, 628, 203, 425
Bon Homme County, South Dakota, 46009, 7013, 45254, 2941, 69900, 1943, 698, 1245
Brookings County, South Dakota, 46011, 33046, 50082, 13638, 156000, 7339, 4520, 2819
Brown County, South Dakota, 46013, 38060, 53100, 17280, 143100, 10968, 6701, 4267
Brule County, South Dakota, 46015, 5330, 49531, 2461, 102900, 1508, 644, 864
Buffalo County, South Dakota, 46017, 2038, 31163, 629, 57900, 240, 42, 198
Butte County, South Dakota, 46019, 10292, 41920, 4667, 118600, 3046, 1684, 1362
Campbell County, South Dakota, 46021, 1548, 45170, 1000, 59800, 550, 132, 418
Charles Mix County, South Dakota, 46023, 9239, 43109, 3850, 82700, 2223, 824, 1399
Clark County, South Dakota, 46025, 3625, 49600, 1785, 76100, 1133, 475, 658
Clay County, South Dakota, 46027, 14011, 36608, 5749, 135000, 2748, 1569, 1179
Codington County, South Dakota, 46029, 27750, 48912, 12621, 145500, 8084, 4681, 3403
Corson County, South Dakota, 46031, 4149, 31676, 1527, 53800, 634, 142, 492
Custer County, South Dakota, 46033, 8394, 52218, 4795, 208900, 3057, 1494, 1563
Davison County, South Dakota, 46035, 19787, 49991, 9067, 133600, 5398, 3008, 2390
Day County, South Dakota, 46037, 5618, 39216, 3670, 81100, 1845, 634, 1211
Deuel County, South Dakota, 46039, 4341, 53152, 2223, 112000, 1575, 827, 748
Dewey County, South Dakota, 46041, 5579, 37206, 1996, 60100, 959, 309, 650
Douglas County, South Dakota, 46043, 2973, 52500, 1434, 73000, 1018, 380, 638
Edmunds County, South Dakota, 46045, 4018, 56000, 1911, 111200, 1297, 555, 742
Fall River County, South Dakota, 46047, 6906, 45997, 4171, 102800, 2193, 928, 1265
Faulk County, South Dakota, 46049, 2359, 43679, 1180, 78600, 732, 221, 511
Grant County, South Dakota, 46051, 7227, 51272, 3543, 107900, 2523, 1328, 1195
Gregory County, South Dakota, 46053, 4226, 37540, 2503, 61200, 1356, 463, 893
Haakon County, South Dakota, 46055, 2083, 41518, 1033, 76800, 671, 246, 425
Hamlin County, South Dakota, 46057, 5982, 58602, 2802, 112100, 1740, 969, 771
Hand County, South Dakota, 46059, 3375, 47163, 1831, 96100, 1063, 403, 660
Hanson County, South Dakota, 46061, 3386, 60741, 1175, 110100, 880, 406, 474
Harding County, South Dakota, 46063, 1328, 52396, 682, 87200, 369, 124, 245
Hughes County, South Dakota, 46065, 17466, 59177, 7758, 167800, 4698, 2733, 1965
Hutchinson County, South Dakota, 46067, 7226, 45075, 3353, 72000, 2213, 742, 1471
Hyde County, South Dakota, 46069, 1413, 51776, 686, 76400, 446, 145, 301
Jackson County, South Dakota, 46071, 3237, 45074, 1234, 57800, 635, 166, 469
Jerauld County, South Dakota, 46073, 2031, 53125, 1038, 81600, 653, 281, 372
Jones County, South Dakota, 46075, 781, 35972, 544, 58300, 292, 80, 212
Kingsbury County, South Dakota, 46077, 5107, 53828, 2718, 88800, 1757, 742, 1015
Lake County, South Dakota, 46079, 12086, 54535, 5619, 139800, 3500, 1793, 1707
Lawrence County, South Dakota, 46081, 24645, 45548, 13183, 180100, 7038, 3799, 3239
Lincoln County, South Dakota, 46083, 49874, 76094, 18781, 193600, 14138, 10571, 3567
Lyman County, South Dakota, 46085, 3837, 43030, 1717, 70300, 1009, 367, 642
McCook County, South Dakota, 46087, 5613, 56954, 2501, 109500, 1756, 850, 906
McPherson County, South Dakota, 46089, 2263, 36375, 1388, 57800, 751, 162, 589
Marshall County, South Dakota, 46091, 4701, 51788, 2555, 97400, 1274, 551, 723
Meade County, South Dakota, 46093, 26381, 52473, 11361, 162700, 7632, 4616, 3016
Mellette County, South Dakota, 46095, 2086, 30938, 817, 49100, 436, 94, 342
Miner County, South Dakota, 46097, 2306, 44938, 1258, 67000, 774, 299, 475
Minnehaha County, South Dakota, 46099, 178942, 53525, 74752, 155400, 44644, 31365, 13279
Moody County, South Dakota, 46101, 6439, 52446, 2824, 122900, 1917, 962, 955
Oglala Lakota County, South Dakota, 46102, 14153, 26369, 3578, 20400, 1545, 203, 1342
Pennington County, South Dakota, 46103, 106085, 50890, 46206, 159800, 27909, 17770, 10139
Perkins County, South Dakota, 46105, 2981, 39773, 1775, 65100, 937, 298, 639
Potter County, South Dakota, 46107, 2307, 46081, 1557, 75400, 856, 287, 569
Roberts County, South Dakota, 46109, 10318, 48614, 4921, 90900, 2573, 926, 1647
Sanborn County, South Dakota, 46111, 2339, 50541, 1221, 75800, 796, 287, 509
Spink County, South Dakota, 46115, 6570, 48217, 3140, 74200, 1934, 837, 1097
Stanley County, South Dakota, 46117, 2962, 56829, 1455, 124100, 1026, 542, 484
Sully County, South Dakota, 46119, 1469, 60417, 802, 94600, 431, 125, 306
Todd County, South Dakota, 46121, 9942, 31128, 3140, 43700, 1229, 303, 926
Tripp County, South Dakota, 46123, 5504, 37153, 3070, 71200, 1697, 622, 1075
Turner County, South Dakota, 46125, 8302, 53378, 3981, 99700, 2730, 1355, 1375
Union County, South Dakota, 46127, 14842, 64471, 6561, 159700, 4432, 2907, 1525
Walworth County, South Dakota, 46129, 5495, 43221, 2992, 76600, 1568, 599, 969
Yankton County, South Dakota, 46135, 22636, 48176, 9746, 128700, 6002, 3132, 2870
Ziebach County, South Dakota, 46137, 2833, 35119, 996, 65700, 431, 123, 308
Anderson County, Tennessee, 47001, 75430, 42880, 34767, 131200, 20901, 11123, 9778
Bedford County, Tennessee, 47003, 45986, 41984, 18519, 115700, 11401, 6959, 4442
Benton County, Tennessee, 47005, 16261, 33240, 8974, 86400, 5176, 2281, 2895
Bledsoe County, Tennessee, 47007, 13686, 37013, 5709, 115400, 3483, 1581, 1902
Blount County, Tennessee, 47009, 125188, 48286, 55744, 166500, 36197, 22015, 14182
Bradley County, Tennessee, 47011, 102062, 42114, 42258, 146200, 25108, 14873, 10235
Campbell County, Tennessee, 47013, 40176, 32028, 20256, 89400, 11185, 4890, 6295
Cannon County, Tennessee, 47015, 13787, 41533, 6057, 124200, 4060, 2232, 1828
Carroll County, Tennessee, 47017, 28353, 35508, 13211, 83500, 8284, 3934, 4350
Carter County, Tennessee, 47019, 56941, 33213, 27817, 108500, 16892, 7908, 8984
Cheatham County, Tennessee, 47021, 39422, 51857, 15797, 159100, 11513, 7808, 3705
Chester County, Tennessee, 47023, 17324, 40167, 7008, 108300, 4499, 2370, 2129
Claiborne County, Tennessee, 47025, 31748, 34899, 15001, 101500, 9142, 4171, 4971
Clay County, Tennessee, 47027, 7780, 28804, 4265, 94000, 2477, 891, 1586
Cocke County, Tennessee, 47029, 35321, 31187, 17387, 99500, 10115, 4330, 5785
Coffee County, Tennessee, 47031, 53448, 41590, 23529, 113100, 14290, 8133, 6157
Crockett County, Tennessee, 47033, 14600, 35464, 6406, 92000, 3752, 1931, 1821
Cumberland County, Tennessee, 47035, 57455, 38576, 28483, 139500, 19014, 9413, 9601
Davidson County, Tennessee, 47037, 658506, 48368, 290647, 169600, 143045, 101639, 41406
Decatur County, Tennessee, 47039, 11686, 37263, 6845, 90500, 3836, 1798, 2038
DeKalb County, Tennessee, 47041, 19038, 38319, 9427, 121800, 4925, 2467, 2458
Dickson County, Tennessee, 47043, 50472, 44680, 21030, 140300, 13388, 7885, 5503
Dyer County, Tennessee, 47045, 38054, 42468, 16772, 98800, 9603, 5595, 4008
Fayette County, Tennessee, 47047, 38814, 54890, 16092, 181700, 11869, 7519, 4350
Fentress County, Tennessee, 47049, 17931, 30259, 8928, 95300, 5644, 2381, 3263
Franklin County, Tennessee, 47051, 41138, 42773, 18900, 110700, 12054, 6158, 5896
Gibson County, Tennessee, 47053, 49572, 38457, 22286, 89200, 14046, 7850, 6196
Giles County, Tennessee, 47055, 28949, 41093, 13831, 108100, 8210, 3956, 4254
Grainger County, Tennessee, 47057, 22736, 35391, 10857, 96400, 7250, 3396, 3854
Greene County, Tennessee, 47059, 68576, 35196, 32104, 109700, 20059, 9763, 10296
Grundy County, Tennessee, 47061, 13524, 27373, 6376, 80400, 4052, 1785, 2267
Hamblen County, Tennessee, 47063, 62999, 37617, 27009, 124200, 16135, 8957, 7178
Hamilton County, Tennessee, 47065, 348121, 48248, 153730, 158600, 87922, 55457, 32465
Hancock County, Tennessee, 47067, 6642, 26898, 3606, 80400, 2104, 730, 1374
Hardeman County, Tennessee, 47069, 26253, 31801, 10865, 83000, 6254, 3126, 3128
Hardin County, Tennessee, 47071, 25900, 35290, 13975, 96900, 7666, 3810, 3856
Hawkins County, Tennessee, 47073, 56595, 36927, 26834, 108600, 17280, 8159, 9121
Haywood County, Tennessee, 47075, 18248, 34182, 8371, 99100, 4352, 2325, 2027
Henderson County, Tennessee, 47077, 28013, 38745, 12814, 92700, 7726, 3834, 3892
Henry County, Tennessee, 47079, 32269, 38234, 17007, 94300, 9987, 5250, 4737
Hickman County, Tennessee, 47081, 24283, 36334, 10281, 93800, 6793, 3800, 2993
Houston County, Tennessee, 47083, 8290, 39401, 4173, 94200, 2351, 1311, 1040
Humphreys County, Tennessee, 47085, 18240, 41949, 8888, 106400, 5613, 2955, 2658
Jackson County, Tennessee, 47087, 11496, 31534, 5820, 101400, 3549, 1694, 1855
Jefferson County, Tennessee, 47089, 52490, 42417, 23592, 128800, 14439, 7954, 6485
Johnson County, Tennessee, 47091, 18017, 30763, 8924, 110500, 5432, 2221, 3211
Knox County, Tennessee, 47093, 444348, 48701, 198119, 160700, 115584, 74161, 41423
Lake County, Tennessee, 47095, 7687, 30086, 2602, 71600, 1262, 656, 606
Lauderdale County, Tennessee, 47097, 27427, 30281, 11282, 81100, 5907, 3076, 2831
Lawrence County, Tennessee, 47099, 42226, 37814, 18146, 98600, 12059, 6325, 5734
Lewis County, Tennessee, 47101, 11944, 36621, 5454, 89600, 3733, 1746, 1987
Lincoln County, Tennessee, 47103, 33550, 40389, 15328, 109100, 9949, 5009, 4940
Loudon County, Tennessee, 47105, 50229, 51107, 22144, 178000, 15358, 8609, 6749
McMinn County, Tennessee, 47107, 52506, 38535, 23267, 113200, 14744, 7736, 7008
McNairy County, Tennessee, 47109, 26103, 32557, 11978, 85000, 7478, 3438, 4040
Macon County, Tennessee, 47111, 22761, 33509, 9942, 100700, 6230, 3263, 2967
Madison County, Tennessee, 47113, 98184, 42544, 42442, 117300, 23739, 14657, 9082
Marion County, Tennessee, 47115, 28306, 41348, 13019, 119100, 8366, 4503, 3863
Marshall County, Tennessee, 47117, 31159, 42661, 13233, 112300, 8715, 5019, 3696
Maury County, Tennessee, 47119, 84089, 47692, 35768, 140800, 22262, 14423, 7839
Meigs County, Tennessee, 47121, 11716, 34424, 5652, 99500, 3669, 1779, 1890
Monroe County, Tennessee, 47123, 45293, 35291, 20831, 113600, 12980, 6456, 6524
Montgomery County, Tennessee, 47125, 185980, 50344, 75280, 145900, 39171, 28442, 10729
Moore County, Tennessee, 47127, 6351, 49427, 2952, 152500, 2088, 1100, 988
Morgan County, Tennessee, 47129, 21794, 39049, 8902, 92900, 5965, 2958, 3007
Obion County, Tennessee, 47131, 31129, 40281, 14611, 87800, 8642, 4771, 3871
Overton County, Tennessee, 47133, 22100, 35287, 10263, 101300, 6908, 3001, 3907
Perry County, Tennessee, 47135, 7864, 31425, 4574, 79900, 2527, 1037, 1490
Pickett County, Tennessee, 47137, 5097, 36773, 3461, 106700, 1841, 829, 1012
Polk County, Tennessee, 47139, 16687, 38925, 8271, 109100, 5269, 2363, 2906
Putnam County, Tennessee, 47141, 73810, 35343, 32648, 144600, 18513, 10738, 7775
Rhea County, Tennessee, 47143, 32394, 36146, 14406, 106400, 8564, 4392, 4172
Roane County, Tennessee, 47145, 53162, 40854, 25604, 120000, 15888, 7409, 8479
Robertson County, Tennessee, 47147, 67426, 53151, 26352, 155800, 18665, 12361, 6304
Rutherford County, Tennessee, 47149, 282558, 56219, 107451, 160700, 66692, 49273, 17419
Scott County, Tennessee, 47151, 22043, 30246, 9872, 84700, 6064, 3125, 2939
Sequatchie County, Tennessee, 47153, 14592, 45408, 6384, 135700, 4160, 2004, 2156
Sevier County, Tennessee, 47155, 93617, 42258, 56241, 159000, 24420, 13973, 10447
Shelby County, Tennessee, 47157, 937750, 46224, 401715, 130800, 199014, 139170, 59844
Smith County, Tennessee, 47159, 19136, 43914, 8585, 114000, 5698, 3079, 2619
Stewart County, Tennessee, 47161, 13286, 42023, 6763, 123100, 4078, 2418, 1660
Sullivan County, Tennessee, 47163, 156752, 40346, 74004, 124900, 48856, 25925, 22931
Sumner County, Tennessee, 47165, 169623, 57382, 67504, 178000, 45012, 31376, 13636
Tipton County, Tennessee, 47167, 61674, 53669, 23385, 139600, 15563, 10717, 4846
Trousdale County, Tennessee, 47169, 7884, 41029, 3402, 129400, 2189, 1396, 793
Unicoi County, Tennessee, 47171, 18069, 33210, 8840, 106200, 5521, 2097, 3424
Union County, Tennessee, 47173, 19096, 37351, 9061, 106800, 5720, 2572, 3148
Van Buren County, Tennessee, 47175, 5596, 40439, 2658, 90700, 1810, 777, 1033
Warren County, Tennessee, 47177, 40015, 35376, 17825, 97700, 10804, 5183, 5621
Washington County, Tennessee, 47179, 125317, 42817, 58443, 145800, 34833, 20522, 14311
Wayne County, Tennessee, 47181, 16897, 30701, 7251, 82300, 4876, 2479, 2397
Weakley County, Tennessee, 47183, 34415, 37037, 15517, 94100, 9271, 4749, 4522
White County, Tennessee, 47185, 26252, 34901, 11572, 97900, 7660, 3926, 3734
Williamson County, Tennessee, 47187, 199456, 96565, 72301, 348600, 56296, 41458, 14838
Wilson County, Tennessee, 47189, 122445, 61070, 48065, 200300, 34643, 23734, 10909
Anderson County, Texas, 48001, 57915, 41327, 20134, 83000, 11791, 4952, 6839
Andrews County, Texas, 48003, 16775, 70423, 6013, 111600, 4090, 1868, 2222
Angelina County, Texas, 48005, 87748, 44223, 36070, 87100, 20178, 8691, 11487
Aransas County, Texas, 48007, 24292, 41690, 15614, 144000, 7040, 2506, 4534
Archer County, Texas, 48009, 8779, 60275, 4129, 107500, 2789, 1327, 1462
Armstrong County, Texas, 48011, 1943, 59737, 933, 106600, 543, 238, 305
Atascosa County, Texas, 48013, 47050, 52192, 17788, 91500, 11409, 5313, 6096
Austin County, Texas, 48015, 28886, 53687, 12978, 157000, 8156, 3603, 4553
Bailey County, Texas, 48017, 7126, 37397, 2787, 58300, 1659, 618, 1041
Bandera County, Texas, 48019, 20796, 49863, 11592, 146100, 6925, 3637, 3288
Bastrop County, Texas, 48021, 76948, 54821, 29522, 129500, 19874, 11058, 8816
Baylor County, Texas, 48023, 3628, 36373, 2695, 81400, 1380, 379, 1001
Bee County, Texas, 48025, 32659, 42302, 10651, 72900, 5417, 2049, 3368
Bell County, Texas, 48027, 326041, 50550, 131684, 127500, 60615, 38291, 22324
Bexar County, Texas, 48029, 1825502, 51150, 675208, 129400, 361851, 232549, 129302
Blanco County, Texas, 48031, 10723, 55504, 5622, 175000, 3138, 1623, 1515
Borden County, Texas, 48033, 705, 73750, 397, 83500, 177, 49, 128
Bosque County, Texas, 48035, 17971, 44674, 9641, 88800, 5418, 2387, 3031
Bowie County, Texas, 48037, 93155, 42670, 39008, 101800, 22053, 10659, 11394
Brazoria County, Texas, 48039, 331741, 69749, 124547, 152900, 80749, 49627, 31122
Brazos County, Texas, 48041, 205271, 39808, 81916, 160000, 33078, 20030, 13048
Brewster County, Texas, 48043, 9235, 38395, 5419, 112700, 2327, 848, 1479
Briscoe County, Texas, 48045, 1670, 38603, 985, 60000, 500, 131, 369
Brooks County, Texas, 48047, 7221, 22741, 3056, 52100, 1430, 355, 1075
Brown County, Texas, 48049, 37833, 41962, 18419, 90400, 9399, 3836, 5563
Burleson County, Texas, 48051, 17293, 51821, 8875, 93100, 5135, 1850, 3285
Burnet County, Texas, 48053, 44144, 49732, 21338, 158900, 12356, 6099, 6257
Caldwell County, Texas, 48055, 39347, 47233, 13864, 115300, 8204, 4375, 3829
Calhoun County, Texas, 48057, 21666, 51078, 11606, 102800, 5663, 2344, 3319
Callahan County, Texas, 48059, 13532, 40981, 6574, 74000, 4313, 1700, 2613
Cameron County, Texas, 48061, 417947, 33266, 145194, 79300, 80885, 35045, 45840
Camp County, Texas, 48063, 12516, 37851, 5675, 78100, 3017, 1246, 1771
Carson County, Texas, 48065, 6068, 66023, 2771, 93700, 2046, 958, 1088
Cass County, Texas, 48067, 30328, 37352, 14400, 81000, 8980, 3578, 5402
Castro County, Texas, 48069, 7948, 39459, 3178, 70600, 1751, 548, 1203
Chambers County, Texas, 48071, 37251, 70544, 14139, 151200, 10529, 6003, 4526
Cherokee County, Texas, 48073, 51167, 39595, 20956, 84500, 12712, 5176, 7536
Childress County, Texas, 48075, 7059, 36633, 3076, 73300, 1531, 740, 791
Clay County, Texas, 48077, 10479, 48297, 5136, 83600, 3461, 1418, 2043
Cochran County, Texas, 48079, 2993, 39113, 1363, 32300, 813, 177, 636
Coke County, Texas, 48081, 3238, 42467, 2667, 79000, 1125, 377, 748
Coleman County, Texas, 48083, 8536, 35156, 5526, 60000, 2325, 891, 1434
Collin County, Texas, 48085, 862215, 84735, 320429, 223400, 203314, 152497, 50817
Collingsworth County, Texas, 48087, 3058, 39743, 1476, 64200, 863, 316, 547
Colorado County, Texas, 48089, 20757, 46618, 10544, 109800, 6206, 2324, 3882
Comal County, Texas, 48091, 119632, 65833, 50288, 214400, 33372, 20236, 13136
Comanche County, Texas, 48093, 13623, 37470, 7242, 72100, 3904, 1235, 2669
Concho County, Texas, 48095, 4086, 48368, 1626, 86000, 638, 191, 447
Cooke County, Texas, 48097, 38761, 52406, 16661, 122700, 10151, 5204, 4947
Coryell County, Texas, 48099, 76128, 49340, 25847, 102700, 12483, 7493, 4990
Cottle County, Texas, 48101, 1510, 34955, 963, 42900, 453, 111, 342
Crane County, Texas, 48103, 4730, 58333, 1652, 75900, 1165, 433, 732
Crockett County, Texas, 48105, 3699, 53678, 1753, 79000, 1056, 397, 659
Crosby County, Texas, 48107, 6007, 37434, 2900, 53900, 1483, 539, 944
Culberson County, Texas, 48109, 2296, 35000, 1020, 60700, 564, 171, 393
Dallam County, Texas, 48111, 7014, 41345, 2880, 72800, 1373, 640, 733
Dallas County, Texas, 48113, 2485003, 50270, 964713, 132700, 451480, 293052, 158428
Dawson County, Texas, 48115, 13542, 41095, 5209, 62100, 3046, 1064, 1982
Deaf Smith County, Texas, 48117, 19245, 43373, 7064, 86700, 4214, 1884, 2330
Delta County, Texas, 48119, 5223, 42432, 2468, 73600, 1496, 619, 877
Denton County, Texas, 48121, 731851, 75050, 273765, 197600, 165668, 128676, 36992
DeWitt County, Texas, 48123, 20540, 49736, 9181, 98200, 5376, 1671, 3705
Dickens County, Texas, 48125, 2281, 39700, 1423, 49600, 657, 188, 469
Dimmit County, Texas, 48127, 10682, 36825, 4353, 58200, 2465, 654, 1811
Donley County, Texas, 48129, 3588, 36681, 2136, 59900, 999, 249, 750
Duval County, Texas, 48131, 11577, 33939, 5533, 52800, 2754, 522, 2232
Eastland County, Texas, 48133, 18328, 34888, 10259, 60100, 4922, 1484, 3438
Ector County, Texas, 48135, 149557, 57150, 55357, 103200, 33733, 15514, 18219
Edwards County, Texas, 48137, 1906, 41813, 1713, 70900, 674, 101, 573
Ellis County, Texas, 48139, 157058, 62465, 56353, 145400, 37889, 24291, 13598
El Paso County, Texas, 48141, 831095, 41637, 282616, 113900, 159647, 93256, 66391
Erath County, Texas, 48143, 40039, 41416, 17251, 121700, 8718, 4304, 4414
Falls County, Texas, 48145, 17410, 36079, 7725, 64900, 3970, 1241, 2729
Fannin County, Texas, 48147, 33748, 44071, 14199, 94600, 8916, 4233, 4683
Fayette County, Texas, 48149, 24849, 47808, 13854, 138100, 7437, 2707, 4730
Fisher County, Texas, 48151, 3858, 41406, 2166, 64900, 1183, 386, 797
Floyd County, Texas, 48153, 6178, 41026, 2999, 65300, 1628, 594, 1034
Foard County, Texas, 48155, 1197, 36477, 821, 55900, 398, 110, 288
Fort Bend County, Texas, 48157, 658331, 89152, 216616, 200200, 162261, 118037, 44224
Franklin County, Texas, 48159, 10599, 41537, 5779, 103200, 3095, 1270, 1825
Freestone County, Texas, 48161, 19586, 44301, 9286, 81400, 5605, 2449, 3156
Frio County, Texas, 48163, 18168, 36404, 5872, 68400, 3373, 1341, 2032
Gaines County, Texas, 48165, 18916, 57635, 6340, 92600, 4320, 1912, 2408
Galveston County, Texas, 48167, 308163, 62313, 138023, 155000, 76189, 46145, 30044
Garza County, Texas, 48169, 6410, 48508, 2040, 80600, 1027, 326, 701
Gillespie County, Texas, 48171, 25398, 54859, 12868, 238300, 8095, 3653, 4442
Glasscock County, Texas, 48173, 1180, 67303, 557, 190200, 287, 92, 195
Goliad County, Texas, 48175, 7410, 51226, 3719, 116300, 2441, 738, 1703
Gonzales County, Texas, 48177, 20172, 42983, 8790, 89200, 4538, 1716, 2822
Gray County, Texas, 48179, 22983, 43288, 10115, 74800, 6067, 2503, 3564
Grayson County, Texas, 48181, 122780, 47952, 54244, 107000, 31593, 16351, 15242
Gregg County, Texas, 48183, 123178, 47639, 50785, 124600, 27568, 14831, 12737
Grimes County, Texas, 48185, 26961, 46195, 10947, 105400, 6986, 2919, 4067
Guadalupe County, Texas, 48187, 143460, 62420, 53101, 163300, 37581, 23912, 13669
Hale County, Texas, 48189, 35504, 43375, 13507, 73400, 7024, 3092, 3932
Hall County, Texas, 48191, 3203, 30950, 1934, 36500, 785, 142, 643
Hamilton County, Texas, 48193, 8266, 42432, 4562, 96600, 2302, 871, 1431
Hansford County, Texas, 48195, 5559, 44219, 2333, 81300, 1487, 515, 972
Hardeman County, Texas, 48197, 3992, 37174, 2395, 45600, 1189, 386, 803
Hardin County, Texas, 48199, 55375, 52614, 23244, 101000, 16554, 6522, 10032
Harris County, Texas, 48201, 4356362, 54457, 1660235, 137800, 823646, 528758, 294888
Harrison County, Texas, 48203, 66417, 45974, 27954, 112700, 17505, 8052, 9453
Hartley County, Texas, 48205, 6121, 63004, 1976, 147300, 1156, 524, 632
Haskell County, Texas, 48207, 5853, 39850, 3434, 48200, 1751, 357, 1394
Hays County, Texas, 48209, 177562, 58583, 67463, 180900, 39185, 28008, 11177
Hemphill County, Texas, 48211, 4115, 62813, 1725, 123400, 1065, 308, 757
Henderson County, Texas, 48213, 79016, 41607, 39867, 91500, 22128, 10099, 12029
Hidalgo County, Texas, 48215, 819217, 34782, 258126, 79200, 152552, 68659, 83893
Hill County, Texas, 48217, 34923, 41382, 16134, 85000, 9318, 3870, 5448
Hockley County, Texas, 48219, 23322, 50665, 9290, 81600, 5504, 2632, 2872
Hood County, Texas, 48221, 53171, 56100, 25350, 153000, 16070, 8738, 7332
Hopkins County, Texas, 48223, 35645, 44396, 15142, 92800, 9431, 4193, 5238
Houston County, Texas, 48225, 22949, 32698, 11543, 76500, 5530, 1761, 3769
Howard County, Texas, 48227, 36105, 49575, 13116, 73800, 7538, 2895, 4643
Hudspeth County, Texas, 48229, 3330, 26384, 1533, 42600, 799, 156, 643
Hunt County, Texas, 48231, 88052, 45197, 36836, 94400, 21524, 11339, 10185
Hutchinson County, Texas, 48233, 21858, 49353, 10585, 73500, 6370, 2590, 3780
Irion County, Texas, 48235, 1644, 58500, 873, 104700, 507, 179, 328
Jack County, Texas, 48237, 8946, 50324, 4101, 76700, 2351, 801, 1550
Jackson County, Texas, 48239, 14486, 54926, 6591, 87600, 3822, 1713, 2109
Jasper County, Texas, 48241, 35768, 40820, 16868, 86500, 9439, 3208, 6231
Jeff Davis County, Texas, 48243, 2232, 50165, 1611, 93300, 772, 141, 631
Jefferson County, Texas, 48245, 252872, 43540, 106857, 97900, 58939, 26846, 32093
Jim Hogg County, Texas, 48247, 5239, 35521, 2519, 68500, 1319, 406, 913
Jim Wells County, Texas, 48249, 41461, 42986, 16206, 70100, 9448, 3303, 6145
Johnson County, Texas, 48251, 155450, 58135, 58451, 119200, 39484, 23389, 16095
Jones County, Texas, 48253, 19978, 43897, 7330, 69000, 4180, 1649, 2531
Karnes County, Texas, 48255, 14879, 45502, 5773, 87200, 3243, 915, 2328
Kaufman County, Texas, 48257, 109289, 60391, 38931, 134700, 27414, 17994, 9420
Kendall County, Texas, 48259, 37361, 73240, 14754, 281200, 9835, 6282, 3553
Kenedy County, Texas, 48261, 565, 36438, 247, 0, 47, 3, 44
Kent County, Texas, 48263, 821, 47024, 539, 72300, 259, 63, 196
Kerr County, Texas, 48265, 50149, 43810, 23977, 158200, 14150, 6388, 7762
Kimble County, Texas, 48267, 4486, 40125, 3351, 85400, 1477, 450, 1027
King County, Texas, 48269, 267, 63250, 159, 73000, 34, 4, 30
Kinney County, Texas, 48271, 3577, 38281, 1734, 72200, 855, 299, 556
Kleberg County, Texas, 48273, 32029, 38247, 12995, 80800, 5769, 2222, 3547
Knox County, Texas, 48275, 3796, 40493, 2041, 42900, 1044, 251, 793
Lamar County, Texas, 48277, 49566, 40748, 22558, 85900, 12420, 5724, 6696
Lamb County, Texas, 48279, 13742, 39851, 6103, 62000, 3395, 1234, 2161
Lampasas County, Texas, 48281, 20219, 49630, 8892, 133300, 5459, 2684, 2775
La Salle County, Texas, 48283, 7191, 37292, 2923, 70100, 1387, 250, 1137
Lavaca County, Texas, 48285, 19549, 48677, 10368, 119300, 6005, 2314, 3691
Lee County, Texas, 48287, 16664, 53902, 7569, 115800, 4469, 1768, 2701
Leon County, Texas, 48289, 16819, 49802, 9522, 102800, 5042, 1881, 3161
Liberty County, Texas, 48291, 77486, 48729, 29363, 87900, 19081, 8686, 10395
Limestone County, Texas, 48293, 23454, 37554, 10551, 83500, 6019, 2629, 3390
Lipscomb County, Texas, 48295, 3483, 63125, 1454, 93000, 855, 297, 558
Live Oak County, Texas, 48297, 11873, 50400, 6097, 86900, 2993, 1151, 1842
Llano County, Texas, 48299, 19323, 48259, 14665, 160600, 6752, 2758, 3994
Loving County, Texas, 48301, 117, 0, 73, 92500, 22, 7, 15
Lubbock County, Texas, 48303, 290782, 46075, 119565, 112600, 61164, 35099, 26065
Lynn County, Texas, 48305, 5764, 39526, 2668, 69900, 1581, 632, 949
McCulloch County, Texas, 48307, 8273, 40561, 4284, 67500, 2468, 790, 1678
McLennan County, Texas, 48309, 241505, 42687, 96935, 114700, 50850, 28107, 22743
McMullen County, Texas, 48311, 778, 46250, 454, 69300, 218, 57, 161
Madison County, Texas, 48313, 13838, 39390, 5162, 103100, 2760, 1165, 1595
Marion County, Texas, 48315, 10248, 34175, 6236, 85500, 3386, 1255, 2131
Martin County, Texas, 48317, 5252, 55682, 1886, 99400, 1231, 472, 759
Mason County, Texas, 48319, 4066, 37654, 2752, 154800, 1348, 395, 953
Matagorda County, Texas, 48321, 36598, 40797, 18985, 93700, 9070, 3382, 5688
Maverick County, Texas, 48323, 56548, 33747, 17929, 88700, 11224, 4960, 6264
Medina County, Texas, 48325, 47392, 57338, 18070, 125100, 12147, 6064, 6083
Menard County, Texas, 48327, 2182, 34464, 1725, 56200, 677, 239, 438
Midland County, Texas, 48329, 151290, 68806, 56735, 166700, 35449, 19699, 15750
Milam County, Texas, 48331, 24344, 38929, 11324, 80600, 6151, 2377, 3774
Mills County, Texas, 48333, 4875, 43920, 2845, 120100, 1507, 525, 982
Mitchell County, Texas, 48335, 9169, 49870, 4055, 48500, 1934, 687, 1247
Montague County, Texas, 48337, 19478, 46172, 10140, 96000, 5894, 2577, 3317
Montgomery County, Texas, 48339, 502586, 68838, 190571, 176900, 124410, 81004, 43406
Moore County, Texas, 48341, 22281, 49802, 7951, 93000, 4650, 1990, 2660
Morris County, Texas, 48343, 12700, 39453, 6019, 69300, 3573, 1292, 2281
Motley County, Texas, 48345, 1071, 31683, 745, 53100, 320, 78, 242
Nacogdoches County, Texas, 48347, 65531, 39538, 27858, 110400, 13310, 5873, 7437
Navarro County, Texas, 48349, 48118, 41505, 20431, 81300, 11624, 5433, 6191
Newton County, Texas, 48351, 14231, 38144, 7147, 74900, 3694, 989, 2705
Nolan County, Texas, 48353, 15061, 37102, 7123, 57200, 3767, 1262, 2505
Nueces County, Texas, 48355, 352060, 50337, 144416, 113200, 72680, 39837, 32843
Ochiltree County, Texas, 48357, 10642, 51517, 4049, 84200, 2695, 992, 1703
Oldham County, Texas, 48359, 2071, 50893, 835, 87100, 487, 216, 271
Orange County, Texas, 48361, 83217, 49763, 35952, 97800, 24507, 10066, 14441
Palo Pinto County, Texas, 48363, 27921, 39516, 15296, 82800, 7195, 2643, 4552
Panola County, Texas, 48365, 23900, 50119, 10968, 91800, 6922, 2744, 4178
Parker County, Texas, 48367, 121418, 67288, 47437, 161800, 33261, 20391, 12870
Parmer County, Texas, 48369, 10004, 45326, 3807, 86400, 2200, 919, 1281
Pecos County, Texas, 48371, 15807, 50305, 5592, 68800, 3044, 1071, 1973
Polk County, Texas, 48373, 46113, 39662, 23624, 81500, 13758, 4985, 8773
Potter County, Texas, 48375, 122352, 38159, 48557, 88200, 24977, 13476, 11501
Presidio County, Texas, 48377, 7304, 32132, 3952, 59400, 1803, 502, 1301
Rains County, Texas, 48379, 11037, 48448, 5282, 98400, 3401, 1508, 1893
Randall County, Texas, 48381, 126782, 60972, 52988, 149000, 33535, 20961, 12574
Reagan County, Texas, 48383, 3598, 52181, 1419, 82900, 836, 243, 593
Real County, Texas, 48385, 3356, 36523, 2725, 109800, 967, 176, 791
Red River County, Texas, 48387, 12567, 31563, 6848, 69200, 3734, 1295, 2439
Reeves County, Texas, 48389, 14179, 43540, 4631, 44600, 2763, 576, 2187
Refugio County, Texas, 48391, 7277, 44240, 3727, 74500, 2035, 648, 1387
Roberts County, Texas, 48393, 931, 63889, 404, 109300, 296, 99, 197
Robertson County, Texas, 48395, 16532, 46501, 8507, 92600, 4315, 1767, 2548
Rockwall County, Texas, 48397, 85536, 87524, 30038, 193300, 22875, 17306, 5569
Runnels County, Texas, 48399, 10445, 41526, 5268, 70000, 2814, 858, 1956
Rusk County, Texas, 48401, 53457, 46173, 21281, 101400, 13271, 5870, 7401
Sabine County, Texas, 48403, 10440, 31307, 8008, 84500, 3389, 837, 2552
San Augustine County, Texas, 48405, 8695, 28275, 5348, 79000, 2319, 460, 1859
San Jacinto County, Texas, 48407, 27023, 43029, 13136, 87800, 8000, 3364, 4636
San Patricio County, Texas, 48409, 66070, 52261, 26880, 95000, 15315, 7323, 7992
San Saba County, Texas, 48411, 5893, 39040, 3172, 72700, 1573, 498, 1075
Schleicher County, Texas, 48413, 3224, 55543, 1492, 79200, 806, 256, 550
Scurry County, Texas, 48415, 17238, 56842, 7137, 89100, 4422, 1812, 2610
Shackelford County, Texas, 48417, 3352, 48750, 1757, 79000, 1060, 320, 740
Shelby County, Texas, 48419, 25725, 37756, 11902, 75100, 6806, 2770, 4036
Sherman County, Texas, 48421, 3066, 51987, 1279, 79700, 777, 280, 497
Smith County, Texas, 48423, 217552, 46929, 88145, 130600, 51618, 27998, 23620
Somervell County, Texas, 48425, 8608, 51912, 3710, 139800, 2318, 1217, 1101
Starr County, Texas, 48427, 62648, 26172, 19590, 65100, 12138, 2871, 9267
Stephens County, Texas, 48429, 9452, 43951, 4925, 83900, 2645, 907, 1738
Sterling County, Texas, 48431, 1346, 53456, 597, 86300, 341, 97, 244
Stonewall County, Texas, 48433, 1414, 42155, 917, 49700, 469, 98, 371
Sutton County, Texas, 48435, 3966, 51667, 2027, 88200, 955, 432, 523
Swisher County, Texas, 48437, 7713, 37040, 3217, 67200, 1901, 757, 1144
Tarrant County, Texas, 48439, 1914526, 58711, 732985, 141000, 410486, 281930, 128556
Taylor County, Texas, 48441, 134435, 45396, 56492, 101500, 29700, 15777, 13923
Terrell County, Texas, 48443, 921, 31111, 814, 64200, 309, 87, 222
Terry County, Texas, 48445, 12687, 37475, 4868, 64200, 2916, 1025, 1891
Throckmorton County, Texas, 48447, 1545, 41042, 1048, 64400, 504, 89, 415
Titus County, Texas, 48449, 32553, 44178, 12070, 97500, 7088, 3539, 3549
Tom Green County, Texas, 48451, 115056, 46711, 47367, 108600, 26465, 13952, 12513
Travis County, Texas, 48453, 1121645, 61451, 464197, 237100, 221425, 156863, 64562
Trinity County, Texas, 48455, 14405, 34295, 8733, 81000, 4306, 1240, 3066
Tyler County, Texas, 48457, 21462, 41360, 10596, 81600, 6723, 2294, 4429
Upshur County, Texas, 48459, 40096, 46673, 16709, 93700, 10916, 5056, 5860
Upton County, Texas, 48461, 3405, 46131, 1514, 57600, 914, 304, 610
Uvalde County, Texas, 48463, 26952, 38568, 10955, 77000, 6205, 2244, 3961
Val Verde County, Texas, 48465, 48980, 42174, 18738, 92400, 9590, 4634, 4956
Van Zandt County, Texas, 48467, 52736, 44002, 22893, 103400, 14512, 6987, 7525
Victoria County, Texas, 48469, 90099, 51758, 35876, 119300, 21403, 10660, 10743
Walker County, Texas, 48471, 69330, 37666, 24844, 116100, 11439, 5125, 6314
Waller County, Texas, 48473, 45847, 51348, 16035, 144200, 9610, 5045, 4565
Ward County, Texas, 48475, 11225, 51345, 4723, 72200, 2830, 956, 1874
Washington County, Texas, 48477, 34236, 51269, 15667, 152800, 8820, 3682, 5138
Webb County, Texas, 48479, 263251, 38862, 76731, 109500, 43933, 25335, 18598
Wharton County, Texas, 48481, 41264, 45176, 17288, 102300, 9980, 3755, 6225
Wheeler County, Texas, 48483, 5618, 52221, 2709, 84000, 1603, 492, 1111
Wichita County, Texas, 48485, 131957, 45543, 55897, 89700, 29453, 16153, 13300
Wilbarger County, Texas, 48487, 13158, 41630, 6280, 69200, 3411, 1561, 1850
Willacy County, Texas, 48489, 22002, 26495, 7102, 49700, 4298, 1243, 3055
Williamson County, Texas, 48491, 473592, 73750, 172113, 196500, 110795, 82286, 28509
Wilson County, Texas, 48493, 45509, 68100, 16931, 159700, 12931, 7372, 5559
Winkler County, Texas, 48495, 7576, 55756, 3006, 45200, 2084, 514, 1570
Wise County, Texas, 48497, 61243, 56897, 23917, 126900, 16435, 9626, 6809
Wood County, Texas, 48499, 42712, 45686, 20928, 111100, 12849, 5842, 7007
Yoakum County, Texas, 48501, 8213, 56153, 2993, 74600, 1983, 629, 1354
Young County, Texas, 48503, 18329, 44693, 8634, 82000, 5513, 2361, 3152
Zapata County, Texas, 48505, 14308, 32162, 6223, 55200, 3399, 971, 2428
Zavala County, Texas, 48507, 12060, 26672, 4297, 41900, 2459, 521, 1938
Beaver County, Utah, 49001, 6461, 50282, 2927, 150000, 1688, 1000, 688
Box Elder County, Utah, 49003, 50991, 55038, 17910, 167500, 12708, 8690, 4018
Cache County, Utah, 49005, 117449, 50497, 38715, 191900, 23289, 15839, 7450
Carbon County, Utah, 49007, 20927, 46900, 9604, 123900, 5546, 3211, 2335
Daggett County, Utah, 49009, 776, 56750, 1165, 174700, 231, 100, 131
Davis County, Utah, 49011, 323374, 71112, 101756, 225800, 75683, 57380, 18303
Duchesne County, Utah, 49013, 19817, 61133, 9715, 172600, 4990, 2821, 2169
Emery County, Utah, 49015, 10728, 49787, 4483, 132700, 2915, 1645, 1270
Garfield County, Utah, 49017, 5069, 42614, 3794, 156600, 1409, 743, 666
Grand County, Utah, 49019, 9388, 41312, 4995, 224800, 2583, 1280, 1303
Iron County, Utah, 49021, 47139, 43855, 19984, 165900, 9597, 6556, 3041
Juab County, Utah, 49023, 10400, 54761, 3538, 165200, 2552, 1631, 921
Kane County, Utah, 49025, 7202, 50194, 5854, 175300, 2221, 1326, 895
Millard County, Utah, 49027, 12582, 51593, 4943, 138400, 3257, 1738, 1519
Morgan County, Utah, 49029, 10276, 74314, 3200, 266400, 2517, 1760, 757
Piute County, Utah, 49031, 1865, 35980, 916, 140800, 468, 207, 261
Rich County, Utah, 49033, 2292, 50781, 2876, 173500, 506, 295, 211
Salt Lake County, Utah, 49035, 1078958, 62117, 372990, 234700, 233092, 172246, 60846
San Juan County, Utah, 49037, 15152, 41484, 5810, 139400, 3103, 1128, 1975
Sanpete County, Utah, 49039, 28261, 50323, 10501, 164400, 5883, 3517, 2366
Sevier County, Utah, 49041, 20871, 46291, 8495, 149400, 5442, 3278, 2164
Summit County, Utah, 49043, 38521, 91773, 27083, 497300, 10388, 7468, 2920
Tooele County, Utah, 49045, 60893, 63552, 20148, 177700, 14347, 11082, 3265
Uintah County, Utah, 49047, 35721, 66815, 12766, 189400, 8365, 4891, 3474
Utah County, Utah, 49049, 551957, 62180, 155425, 228400, 99369, 75127, 24242
Wasatch County, Utah, 49051, 26661, 66486, 11352, 316800, 5909, 4332, 1577
Washington County, Utah, 49053, 148244, 50774, 61026, 212600, 33647, 20982, 12665
Wayne County, Utah, 49055, 2722, 40645, 1613, 198600, 805, 429, 376
Weber County, Utah, 49057, 238682, 56581, 87515, 168000, 57074, 40880, 16194
Addison County, Vermont, 50001, 36943, 59688, 16891, 237300, 10643, 6973, 3670
Bennington County, Vermont, 50003, 36589, 49573, 20919, 211300, 11243, 6980, 4263
Caledonia County, Vermont, 50005, 31012, 45323, 16022, 162400, 9047, 5250, 3797
Chittenden County, Vermont, 50007, 159711, 65350, 67027, 271300, 41223, 29121, 12102
Essex County, Vermont, 50009, 6207, 36599, 5025, 122800, 2156, 1077, 1079
Franklin County, Vermont, 50011, 48418, 58199, 21886, 203000, 13857, 9528, 4329
Grand Isle County, Vermont, 50013, 6952, 62608, 5096, 261300, 2354, 1560, 794
Lamoille County, Vermont, 50015, 25027, 50939, 13122, 220700, 7360, 4742, 2618
Orange County, Vermont, 50017, 28929, 53869, 14889, 189400, 9691, 6095, 3596
Orleans County, Vermont, 50019, 27146, 42831, 16486, 154100, 8789, 4837, 3952
Rutland County, Vermont, 50021, 60530, 49372, 33742, 178500, 17838, 10895, 6943
Washington County, Vermont, 50023, 59132, 58788, 30076, 211200, 18046, 11645, 6401
Windham County, Vermont, 50025, 43858, 51045, 29861, 209200, 13188, 8117, 5071
Windsor County, Vermont, 50027, 56150, 52965, 34132, 216300, 17149, 10398, 6751
Accomack County, Virginia, 51001, 33115, 39412, 21031, 153300, 9919, 4312, 5607
Albemarle County, Virginia, 51003, 103108, 68449, 43579, 313800, 25281, 16568, 8713
Alleghany County, Virginia, 51005, 16066, 45007, 8063, 112000, 5337, 2634, 2703
Amelia County, Virginia, 51007, 12777, 56850, 5414, 170800, 3824, 2543, 1281
Amherst County, Virginia, 51009, 32148, 47558, 14058, 150100, 9534, 5758, 3776
Appomattox County, Virginia, 51011, 15208, 48823, 7051, 148200, 4794, 3030, 1764
Arlington County, Virginia, 51013, 223945, 105763, 109443, 607700, 43697, 34036, 9661
Augusta County, Virginia, 51015, 74053, 54558, 31724, 197400, 22341, 13608, 8733
Bath County, Virginia, 51017, 4583, 43646, 3394, 153700, 1495, 767, 728
Bedford County, Virginia, 51019, 76463, 56316, 35546, 196500, 24850, 15334, 9516
Bland County, Virginia, 51021, 6662, 45294, 3274, 100300, 2089, 822, 1267
Botetourt County, Virginia, 51023, 33155, 60454, 14664, 208500, 11314, 7093, 4221
Brunswick County, Virginia, 51025, 16930, 36919, 8158, 105200, 4319, 2360, 1959
Buchanan County, Virginia, 51027, 23486, 29679, 11489, 71500, 7449, 2200, 5249
Buckingham County, Virginia, 51029, 17068, 40331, 7263, 131800, 4347, 2586, 1761
Campbell County, Virginia, 51031, 55012, 47699, 25100, 151500, 16572, 9901, 6671
Caroline County, Virginia, 51033, 29349, 59227, 11927, 186800, 8855, 6316, 2539
Carroll County, Virginia, 51035, 29856, 35000, 16621, 107900, 9915, 4615, 5300
Charles City County, Virginia, 51036, 7118, 49563, 3303, 159600, 2344, 1321, 1023
Charlotte County, Virginia, 51037, 12313, 35079, 6298, 94300, 3281, 1431, 1850
Chesterfield County, Virginia, 51041, 328176, 72609, 125393, 216800, 89151, 69375, 19776
Clarke County, Virginia, 51043, 14299, 71295, 6261, 329500, 4195, 3082, 1113
Craig County, Virginia, 51045, 5212, 44330, 2955, 153000, 1794, 897, 897
Culpeper County, Virginia, 51047, 48424, 66697, 17989, 251600, 12023, 9170, 2853
Cumberland County, Virginia, 51049, 9859, 39301, 4650, 137800, 2893, 1864, 1029
Dickenson County, Virginia, 51051, 15463, 33624, 7525, 74100, 4805, 1686, 3119
Dinwiddie County, Virginia, 51053, 28110, 51397, 11542, 155300, 7617, 4436, 3181
Essex County, Virginia, 51057, 11151, 42760, 5777, 164400, 3189, 1713, 1476
Fairfax County, Virginia, 51059, 1128722, 112552, 409963, 501200, 265693, 212034, 53659
Fauquier County, Virginia, 51061, 67463, 91609, 26052, 357200, 18674, 13837, 4837
Floyd County, Virginia, 51063, 15523, 48005, 7889, 155300, 4872, 2367, 2505
Fluvanna County, Virginia, 51065, 26014, 63938, 10596, 215600, 8124, 5660, 2464
Franklin County, Virginia, 51067, 56315, 46870, 29419, 168400, 17950, 10409, 7541
Frederick County, Virginia, 51069, 81340, 69098, 32152, 225300, 23010, 16420, 6590
Giles County, Virginia, 51071, 16907, 46390, 8327, 104700, 5499, 2749, 2750
Gloucester County, Virginia, 51073, 37001, 61121, 16066, 224100, 11282, 7783, 3499
Goochland County, Virginia, 51075, 21721, 79330, 8807, 318400, 7088, 4869, 2219
Grayson County, Virginia, 51077, 15573, 29942, 9166, 91500, 5059, 2066, 2993
Greene County, Virginia, 51079, 18938, 61550, 7905, 241800, 5512, 4093, 1419
Greensville County, Virginia, 51081, 11760, 38012, 4122, 99800, 2495, 1225, 1270
Halifax County, Virginia, 51083, 35506, 35240, 18057, 104700, 10344, 4845, 5499
Hanover County, Virginia, 51085, 101340, 78645, 39391, 255400, 30348, 21337, 9011
Henrico County, Virginia, 51087, 318864, 61934, 134346, 216300, 78341, 59062, 19279
Henry County, Virginia, 51089, 52580, 35293, 26144, 95400, 16711, 8370, 8341
Highland County, Virginia, 51091, 2244, 43914, 1918, 169100, 883, 296, 587
Isle of Wight County, Virginia, 51093, 35740, 65741, 15001, 243000, 10749, 7164, 3585
James City County, Virginia, 51095, 70673, 75710, 31392, 319100, 20984, 14223, 6761
King and Queen County, Virginia, 51097, 7106, 48292, 3446, 155800, 2196, 1203, 993
King George County, Virginia, 51099, 24933, 81688, 9706, 282500, 6120, 4408, 1712
King William County, Virginia, 51101, 16097, 62031, 6632, 198500, 4931, 3535, 1396
Lancaster County, Virginia, 51103, 11129, 50374, 7544, 229100, 3874, 1626, 2248
Lee County, Virginia, 51105, 25206, 31086, 11728, 78400, 6906, 2513, 4393
Loudoun County, Virginia, 51107, 351129, 123453, 118919, 452300, 87461, 76441, 11020
Louisa County, Virginia, 51109, 33986, 57829, 16692, 193700, 10204, 6842, 3362
Lunenburg County, Virginia, 51111, 12558, 39506, 5933, 106600, 3326, 1686, 1640
Madison County, Virginia, 51113, 13147, 47736, 5983, 241200, 3635, 2097, 1538
Mathews County, Virginia, 51115, 8880, 63845, 5702, 250900, 3152, 1603, 1549
Mecklenburg County, Virginia, 51117, 31555, 37356, 18661, 125400, 9242, 4578, 4664
Middlesex County, Virginia, 51119, 10717, 54654, 7211, 245800, 3613, 1934, 1679
Montgomery County, Virginia, 51121, 96467, 46663, 39038, 205100, 19093, 11781, 7312
Nelson County, Virginia, 51125, 14858, 47118, 10017, 212000, 4568, 2495, 2073
New Kent County, Virginia, 51127, 19560, 73041, 7736, 245000, 6240, 4489, 1751
Northampton County, Virginia, 51131, 12184, 35055, 7323, 160900, 3614, 1582, 2032
Northumberland County, Virginia, 51133, 12304, 51885, 9096, 242000, 4906, 2677, 2229
Nottoway County, Virginia, 51135, 15711, 36284, 6699, 132900, 3651, 1981, 1670
Orange County, Virginia, 51137, 34596, 65166, 14789, 231200, 9669, 6896, 2773
Page County, Virginia, 51139, 23843, 43895, 11636, 176000, 6596, 3205, 3391
Patrick County, Virginia, 51141, 18264, 33982, 10085, 111100, 5974, 2466, 3508
Pittsylvania County, Virginia, 51143, 62794, 41824, 31366, 111900, 20121, 10741, 9380
Powhatan County, Virginia, 51145, 28207, 77896, 10272, 257300, 8499, 6390, 2109
Prince Edward County, Virginia, 51147, 23022, 41697, 9269, 151500, 4801, 2495, 2306
Prince George County, Virginia, 51149, 37380, 61857, 12192, 207500, 7835, 5156, 2679
Prince William County, Virginia, 51153, 437271, 98657, 142786, 333100, 97744, 83446, 14298
Pulaski County, Virginia, 51155, 34528, 47495, 17256, 135700, 10416, 5572, 4844
Rappahannock County, Virginia, 51157, 7431, 57210, 3936, 367000, 2492, 1357, 1135
Richmond County, Virginia, 51159, 8989, 47288, 3886, 150000, 2138, 1047, 1091
Roanoke County, Virginia, 51161, 93633, 60519, 40439, 189200, 28496, 18141, 10355
Rockbridge County, Virginia, 51163, 22444, 48901, 11231, 188500, 6927, 3646, 3281
Rockingham County, Virginia, 51165, 77785, 53744, 34269, 197300, 22449, 13273, 9176
Russell County, Virginia, 51167, 28245, 35045, 13428, 96000, 8614, 3385, 5229
Scott County, Virginia, 51169, 22570, 37240, 11876, 91900, 7289, 2961, 4328
Shenandoah County, Virginia, 51171, 42724, 49406, 21026, 198900, 12417, 7455, 4962
Smyth County, Virginia, 51173, 31734, 37983, 15356, 88900, 8942, 4227, 4715
Southampton County, Virginia, 51175, 18410, 48962, 7529, 159700, 4656, 2739, 1917
Spotsylvania County, Virginia, 51177, 127691, 78125, 45979, 248300, 32589, 25716, 6873
Stafford County, Virginia, 51179, 137145, 97144, 45759, 305300, 33314, 27558, 5756
Surry County, Virginia, 51181, 6823, 53673, 3497, 169000, 2134, 1287, 847
Sussex County, Virginia, 51183, 11864, 39194, 4007, 140400, 2061, 951, 1110
Tazewell County, Virginia, 51185, 43870, 37664, 20716, 91400, 13438, 5797, 7641
Warren County, Virginia, 51187, 38481, 61454, 16099, 213500, 11020, 8014, 3006
Washington County, Virginia, 51191, 54759, 43310, 25704, 130200, 17273, 9254, 8019
Westmoreland County, Virginia, 51193, 17557, 47911, 10752, 191600, 5179, 2984, 2195
Wise County, Virginia, 51195, 40530, 37407, 17851, 87500, 10627, 5077, 5550
Wythe County, Virginia, 51197, 29190, 41360, 14159, 123900, 8270, 4260, 4010
York County, Virginia, 51199, 66471, 81749, 27150, 312600, 17512, 12661, 4851
Alexandria city, Virginia, 51510, 149315, 89134, 74317, 502500, 28410, 22824, 5586
Bristol city, Virginia, 51520, 17524, 35368, 8841, 114500, 4257, 2184, 2073
Buena Vista city, Virginia, 51530, 6666, 29097, 2920, 115000, 1605, 1005, 600
Charlottesville city, Virginia, 51540, 45084, 49775, 19886, 285300, 7735, 5319, 2416
Chesapeake city, Virginia, 51550, 230601, 68620, 86657, 253800, 57374, 45453, 11921
Colonial Heights city, Virginia, 51570, 17515, 50304, 7808, 169300, 4461, 2824, 1637
Covington city, Virginia, 51580, 5736, 34746, 3035, 68600, 1834, 951, 883
Danville city, Virginia, 51590, 42450, 32315, 22376, 88600, 10013, 5307, 4706
Emporia city, Virginia, 51595, 5672, 28601, 2686, 115000, 1050, 567, 483
Fairfax city, Virginia, 51600, 23402, 105297, 8780, 470300, 5925, 4510, 1415
Falls Church city, Virginia, 51610, 13308, 120522, 5601, 718900, 3031, 2550, 481
Franklin city, Virginia, 51620, 8457, 32399, 3888, 178700, 1648, 1233, 415
Fredericksburg city, Virginia, 51630, 27395, 51762, 11252, 317900, 3473, 2589, 884
Galax city, Virginia, 51640, 6876, 30604, 3514, 91000, 1765, 885, 880
Hampton city, Virginia, 51650, 137081, 49190, 60168, 188000, 30486, 22212, 8274
Harrisonburg city, Virginia, 51660, 51388, 38750, 17942, 199400, 5926, 4216, 1710
Hopewell city, Virginia, 51670, 22279, 39064, 10223, 123800, 4470, 2812, 1658
Lexington city, Virginia, 51678, 7071, 34017, 1911, 242700, 941, 638, 303
Lynchburg city, Virginia, 51680, 78158, 39589, 32252, 149200, 14458, 9503, 4955
Manassas city, Virginia, 51683, 40743, 72890, 13284, 276700, 7988, 6516, 1472
Manassas Park city, Virginia, 51685, 15625, 73528, 4895, 248300, 3246, 2833, 413
Martinsville city, Virginia, 51690, 13624, 29587, 7176, 89100, 3096, 1818, 1278
Newport News city, Virginia, 51700, 181323, 50077, 77175, 193100, 34694, 24946, 9748
Norfolk city, Virginia, 51710, 245452, 44480, 96121, 193400, 37853, 27943, 9910
Norton city, Virginia, 51720, 4007, 27731, 1917, 91600, 908, 368, 540
Petersburg city, Virginia, 51730, 32123, 31798, 16464, 111900, 5301, 3327, 1974
Poquoson city, Virginia, 51735, 12077, 83735, 4751, 307800, 3811, 2614, 1197
Portsmouth city, Virginia, 51740, 96135, 45676, 40987, 169800, 20129, 14789, 5340
Radford city, Virginia, 51750, 17057, 29912, 6507, 148600, 2395, 1455, 940
Richmond city, Virginia, 51760, 213735, 40758, 99449, 193700, 36875, 25979, 10896
Roanoke city, Virginia, 51770, 98736, 39930, 47321, 134400, 22688, 15559, 7129
Salem city, Virginia, 51775, 25165, 50068, 10851, 173100, 6651, 3909, 2742
Staunton city, Virginia, 51790, 24193, 40842, 11782, 165400, 5900, 3724, 2176
Suffolk city, Virginia, 51800, 86184, 65499, 34368, 235300, 21882, 16621, 5261
Virginia Beach city, Virginia, 51810, 448290, 66634, 180824, 259900, 105601, 83444, 22157
Waynesboro city, Virginia, 51820, 21150, 45643, 9868, 156200, 5215, 3646, 1569
Williamsburg city, Virginia, 51830, 14754, 48639, 5020, 320600, 2086, 1404, 682
Winchester city, Virginia, 51840, 27168, 45363, 11903, 216300, 4758, 3064, 1694
Adams County, Washington, 53001, 19081, 46564, 6271, 138400, 3788, 2174, 1614
Asotin County, Washington, 53003, 22040, 44394, 9855, 171900, 6259, 3403, 2856
Benton County, Washington, 53005, 184930, 60251, 71473, 184200, 45508, 29487, 16021
Chelan County, Washington, 53007, 74267, 51837, 35934, 246300, 17761, 10654, 7107
Clallam County, Washington, 53009, 72397, 47253, 35747, 217100, 21864, 11798, 10066
Clark County, Washington, 53011, 444506, 60756, 170937, 234800, 104383, 77470, 26913
Columbia County, Washington, 53013, 3989, 38581, 2126, 154800, 1243, 582, 661
Cowlitz County, Washington, 53015, 102338, 47452, 43503, 175300, 26091, 16795, 9296
Douglas County, Washington, 53017, 39599, 53636, 16164, 209700, 10207, 6617, 3590
Ferry County, Washington, 53019, 7652, 38125, 4396, 166000, 2209, 953, 1256
Franklin County, Washington, 53021, 86443, 56980, 26029, 166800, 16595, 11880, 4715
Garfield County, Washington, 53023, 2230, 45855, 1239, 140900, 650, 310, 340
Grant County, Washington, 53025, 92070, 48714, 35391, 157500, 18369, 10949, 7420
Grays Harbor County, Washington, 53027, 71419, 43538, 35262, 158300, 18452, 10755, 7697
Island County, Washington, 53029, 79329, 58815, 40594, 290900, 22447, 14585, 7862
Jefferson County, Washington, 53031, 30083, 49279, 17914, 284500, 10072, 5363, 4709
King County, Washington, 53033, 2045756, 75302, 871836, 384300, 470632, 349828, 120804
Kitsap County, Washington, 53035, 255441, 62941, 108689, 258700, 65671, 46890, 18781
Kittitas County, Washington, 53037, 42204, 46458, 22364, 242900, 9767, 6113, 3654
Klickitat County, Washington, 53039, 20820, 48319, 9894, 200600, 5395, 2838, 2557
Lewis County, Washington, 53041, 75515, 44100, 34110, 174000, 19888, 11681, 8207
Lincoln County, Washington, 53043, 10363, 46069, 5828, 142500, 3451, 1827, 1624
Mason County, Washington, 53045, 60791, 50406, 32605, 204300, 17719, 11185, 6534
Okanogan County, Washington, 53047, 41332, 40730, 22410, 162700, 11326, 5739, 5587
Pacific County, Washington, 53049, 20645, 37684, 15700, 156200, 6574, 3220, 3354
Pend Oreille County, Washington, 53051, 12968, 40599, 7995, 179200, 4069, 2045, 2024
Pierce County, Washington, 53053, 821952, 59953, 331369, 232600, 185160, 137402, 47758
San Juan County, Washington, 53055, 15956, 55960, 13619, 465500, 5507, 3152, 2355
Skagit County, Washington, 53057, 119343, 54129, 51874, 249800, 30610, 19575, 11035
Skamania County, Washington, 53059, 11243, 52374, 5653, 243000, 3163, 1931, 1232
Snohomish County, Washington, 53061, 746653, 70722, 294147, 293000, 181256, 138098, 43158
Spokane County, Washington, 53063, 480832, 50079, 205487, 183300, 119096, 80966, 38130
Stevens County, Washington, 53065, 43548, 41978, 21159, 172600, 13265, 7698, 5567
Thurston County, Washington, 53067, 262723, 61677, 110904, 239400, 66262, 46588, 19674
Wahkiakum County, Washington, 53069, 4035, 44485, 2054, 178400, 1352, 633, 719
Walla Walla County, Washington, 53071, 59726, 47946, 23768, 192400, 13944, 7811, 6133
Whatcom County, Washington, 53073, 207100, 53145, 91911, 274700, 50359, 33289, 17070
Whitman County, Washington, 53075, 46737, 36631, 19708, 181800, 7738, 4412, 3326
Yakima County, Washington, 53077, 247408, 44749, 86208, 158200, 49969, 30792, 19177
Barbour County, West Virginia, 54001, 16731, 37066, 7850, 92600, 4406, 1899, 2507
Berkeley County, West Virginia, 54003, 108724, 55239, 45872, 162500, 29992, 20715, 9277
Boone County, West Virginia, 54005, 24000, 39958, 11066, 75700, 7310, 2758, 4552
Braxton County, West Virginia, 54007, 14466, 32750, 7389, 79500, 4202, 1649, 2553
Brooke County, West Virginia, 54009, 23665, 46215, 10918, 86500, 7348, 3493, 3855
Cabell County, West Virginia, 54011, 96824, 38344, 46376, 112800, 24421, 12471, 11950
Calhoun County, West Virginia, 54013, 7557, 35568, 3947, 71100, 2484, 873, 1611
Clay County, West Virginia, 54015, 9141, 31325, 4583, 78000, 2846, 952, 1894
Doddridge County, West Virginia, 54017, 8201, 39974, 3920, 92000, 2288, 836, 1452
Fayette County, West Virginia, 54019, 45534, 36293, 21540, 77100, 13569, 5549, 8020
Gilmer County, West Virginia, 54021, 8644, 37536, 3459, 78700, 2124, 808, 1316
Grant County, West Virginia, 54023, 11815, 39088, 6444, 124900, 3286, 1469, 1817
Greenbrier County, West Virginia, 54025, 35666, 39746, 19095, 105300, 11248, 5340, 5908
Hampshire County, West Virginia, 54027, 23542, 27995, 13761, 121400, 5542, 2217, 3325
Hancock County, West Virginia, 54029, 30201, 39959, 14454, 86400, 9471, 4651, 4820
Hardy County, West Virginia, 54031, 13936, 40303, 8122, 118800, 3929, 1993, 1936
Harrison County, West Virginia, 54033, 68998, 43987, 31519, 97800, 20242, 9796, 10446
Jackson County, West Virginia, 54035, 29256, 41314, 13259, 111600, 8668, 4254, 4414
Jefferson County, West Virginia, 54037, 55214, 66677, 22408, 207300, 15051, 11115, 3936
Kanawha County, West Virginia, 54039, 190781, 45882, 92446, 103100, 57133, 29335, 27798
Lewis County, West Virginia, 54041, 16434, 37849, 7940, 95500, 4591, 1966, 2625
Lincoln County, West Virginia, 54043, 21560, 35800, 9831, 81000, 6149, 1877, 4272
Logan County, West Virginia, 54045, 35760, 36763, 16729, 82100, 10662, 4195, 6467
McDowell County, West Virginia, 54047, 20802, 24921, 11221, 35500, 6277, 935, 5342
Marion County, West Virginia, 54049, 56790, 43165, 26367, 99800, 17218, 7790, 9428
Marshall County, West Virginia, 54051, 32480, 45182, 15855, 94600, 10501, 4999, 5502
Mason County, West Virginia, 54053, 27177, 36448, 12952, 79600, 8614, 3901, 4713
Mercer County, West Virginia, 54055, 61891, 36195, 29898, 85200, 18320, 7593, 10727
Mineral County, West Virginia, 54057, 27755, 31790, 13076, 118800, 6456, 2946, 3510
Mingo County, West Virginia, 54059, 25931, 33221, 12647, 73200, 8232, 2889, 5343
Monongalia County, West Virginia, 54061, 101668, 45467, 44167, 167600, 21173, 11559, 9614
Monroe County, West Virginia, 54063, 13525, 36918, 7560, 101600, 4700, 2017, 2683
Morgan County, West Virginia, 54065, 17475, 39324, 9820, 165000, 5194, 3028, 2166
Nicholas County, West Virginia, 54067, 25930, 39171, 13031, 83100, 8540, 3509, 5031
Ohio County, West Virginia, 54069, 43637, 40569, 21097, 107500, 12583, 6041, 6542
Pendleton County, West Virginia, 54071, 7402, 36953, 5161, 100500, 2430, 816, 1614
Pleasants County, West Virginia, 54073, 7636, 44288, 3382, 100800, 2407, 1124, 1283
Pocahontas County, West Virginia, 54075, 8697, 36827, 8841, 115500, 3013, 1274, 1739
Preston County, West Virginia, 54077, 33809, 45064, 15060, 107100, 9943, 4471, 5472
Putnam County, West Virginia, 54079, 56596, 56774, 23699, 148600, 17999, 10060, 7939
Raleigh County, West Virginia, 54081, 78493, 41032, 36000, 101700, 22779, 10924, 11855
Randolph County, West Virginia, 54083, 29365, 39457, 14173, 101200, 8435, 3936, 4499
Ritchie County, West Virginia, 54085, 10140, 37636, 5816, 73100, 3130, 1263, 1867
Roane County, West Virginia, 54087, 14636, 31813, 7379, 88900, 4486, 1829, 2657
Summers County, West Virginia, 54089, 13544, 36651, 7678, 89200, 4374, 1739, 2635
Taylor County, West Virginia, 54091, 16977, 43970, 7521, 88800, 5309, 2487, 2822
Tucker County, West Virginia, 54093, 6972, 40533, 5346, 104000, 2382, 1016, 1366
Tyler County, West Virginia, 54095, 9033, 38854, 4990, 87100, 2789, 1248, 1541
Upshur County, West Virginia, 54097, 24560, 40330, 11148, 108800, 6910, 3102, 3808
Wayne County, West Virginia, 54099, 41499, 36318, 19245, 82800, 12838, 5531, 7307
Webster County, West Virginia, 54101, 8927, 29086, 5412, 64800, 2869, 952, 1917
Wetzel County, West Virginia, 54103, 16157, 39096, 8154, 83500, 5170, 1958, 3212
Wirt County, West Virginia, 54105, 5841, 39352, 3243, 80300, 1981, 680, 1301
Wood County, West Virginia, 54107, 86559, 41884, 40265, 107000, 25791, 14090, 11701
Wyoming County, West Virginia, 54109, 22866, 33730, 10852, 60200, 7461, 2183, 5278
Adams County, Wisconsin, 55001, 20451, 43640, 17410, 131600, 6588, 3485, 3103
Ashland County, Wisconsin, 55003, 15993, 39381, 9625, 109000, 4657, 2469, 2188
Barron County, Wisconsin, 55005, 45686, 45714, 23683, 134100, 13965, 8331, 5634
Bayfield County, Wisconsin, 55007, 15050, 46665, 13134, 161300, 5691, 3046, 2645
Brown County, Wisconsin, 55009, 254717, 53527, 106532, 158400, 66370, 46118, 20252
Buffalo County, Wisconsin, 55011, 13319, 50196, 6672, 145500, 4350, 2267, 2083
Burnett County, Wisconsin, 55013, 15334, 41135, 15316, 148800, 5879, 3241, 2638
Calumet County, Wisconsin, 55015, 49678, 67427, 19898, 165200, 15078, 10179, 4899
Chippewa County, Wisconsin, 55017, 63209, 52109, 27530, 148500, 18024, 11129, 6895
Clark County, Wisconsin, 55019, 34518, 45048, 15053, 113100, 9866, 5233, 4633
Columbia County, Wisconsin, 55021, 56607, 59769, 26185, 175300, 16817, 11635, 5182
Crawford County, Wisconsin, 55023, 16483, 44459, 8821, 123500, 4911, 2501, 2410
Dane County, Wisconsin, 55025, 510198, 62865, 220503, 230800, 122677, 89518, 33159
Dodge County, Wisconsin, 55027, 88547, 53783, 37229, 153100, 24103, 15594, 8509
Door County, Wisconsin, 55029, 27731, 51928, 24238, 194100, 10209, 5824, 4385
Douglas County, Wisconsin, 55031, 43799, 47095, 22887, 131200, 12670, 7736, 4934
Dunn County, Wisconsin, 55033, 44159, 49788, 18072, 153700, 11111, 6922, 4189
Eau Claire County, Wisconsin, 55035, 101281, 49513, 42708, 152000, 24678, 16367, 8311
Florence County, Wisconsin, 55037, 4476, 48643, 4750, 140700, 1655, 832, 823
Fond du Lac County, Wisconsin, 55039, 101920, 55473, 44326, 146100, 29372, 18642, 10730
Forest County, Wisconsin, 55041, 9150, 40636, 9055, 126500, 2926, 1548, 1378
Grant County, Wisconsin, 55043, 51489, 49067, 21728, 133200, 13770, 7634, 6136
Green County, Wisconsin, 55045, 37044, 56219, 15837, 160200, 10873, 6971, 3902
Green Lake County, Wisconsin, 55047, 18966, 46780, 10620, 140300, 5834, 3419, 2415
Iowa County, Wisconsin, 55049, 23769, 55188, 10764, 163300, 7452, 4815, 2637
Iron County, Wisconsin, 55051, 5907, 42543, 6009, 104700, 2368, 1246, 1122
Jackson County, Wisconsin, 55053, 20543, 47851, 9755, 127000, 5895, 3569, 2326
Jefferson County, Wisconsin, 55055, 84345, 56877, 35264, 173000, 23140, 16102, 7038
Juneau County, Wisconsin, 55057, 26494, 44961, 14768, 116800, 7646, 4445, 3201
Kenosha County, Wisconsin, 55059, 167738, 54918, 69510, 161800, 41580, 28599, 12981
Kewaunee County, Wisconsin, 55061, 20483, 56863, 9335, 148100, 6610, 3884, 2726
La Crosse County, Wisconsin, 55063, 117048, 50539, 49008, 156700, 30084, 19441, 10643
Lafayette County, Wisconsin, 55065, 16835, 51445, 7240, 124000, 5083, 2923, 2160
Langlade County, Wisconsin, 55067, 19551, 41775, 12406, 109700, 6534, 3833, 2701
Lincoln County, Wisconsin, 55069, 28286, 49721, 16854, 132600, 9381, 5639, 3742
Manitowoc County, Wisconsin, 55071, 80521, 48398, 37197, 126700, 25502, 15374, 10128
Marathon County, Wisconsin, 55073, 135177, 54083, 58226, 144500, 39406, 24351, 15055
Marinette County, Wisconsin, 55075, 41287, 43425, 30393, 110500, 13841, 7687, 6154
Marquette County, Wisconsin, 55077, 15140, 46242, 9882, 144500, 5088, 2934, 2154
Menominee County, Wisconsin, 55078, 4451, 35343, 2307, 83500, 875, 274, 601
Milwaukee County, Wisconsin, 55079, 955939, 43873, 417484, 151700, 190470, 130955, 59515
Monroe County, Wisconsin, 55081, 45274, 50694, 19505, 135300, 12016, 7332, 4684
Oconto County, Wisconsin, 55083, 37476, 52765, 23705, 150900, 12951, 8160, 4791
Oneida County, Wisconsin, 55085, 35653, 46516, 30329, 162600, 12525, 7642, 4883
Outagamie County, Wisconsin, 55087, 180430, 58765, 74583, 155900, 50215, 34156, 16059
Ozaukee County, Wisconsin, 55089, 87273, 76433, 36586, 245700, 26494, 17667, 8827
Pepin County, Wisconsin, 55091, 7372, 49516, 3609, 141800, 2412, 1363, 1049
Pierce County, Wisconsin, 55093, 40799, 61611, 16220, 191000, 10983, 7507, 3476
Polk County, Wisconsin, 55095, 43572, 50714, 24251, 155100, 13862, 9147, 4715
Portage County, Wisconsin, 55097, 70432, 51613, 30287, 151700, 19054, 11852, 7202
Price County, Wisconsin, 55099, 13800, 43137, 10975, 116700, 5166, 2678, 2488
Racine County, Wisconsin, 55101, 194895, 55584, 82261, 164600, 52516, 35122, 17394
Richland County, Wisconsin, 55103, 17746, 44810, 8848, 124200, 5504, 3053, 2451
Rock County, Wisconsin, 55105, 160727, 50324, 68332, 131800, 44177, 29780, 14397
Rusk County, Wisconsin, 55107, 14357, 39194, 8950, 105200, 4839, 2531, 2308
St. Croix County, Wisconsin, 55109, 86118, 70886, 34468, 205400, 25009, 18932, 6077
Sauk County, Wisconsin, 55111, 62992, 51055, 29833, 166700, 17540, 11005, 6535
Sawyer County, Wisconsin, 55113, 16483, 41665, 16152, 160400, 5521, 3012, 2509
Shawano County, Wisconsin, 55115, 41563, 47861, 20696, 131500, 12919, 7383, 5536
Sheboygan County, Wisconsin, 55117, 115226, 53713, 50648, 148200, 33009, 21766, 11243
Taylor County, Wisconsin, 55119, 20569, 45420, 10594, 127200, 6750, 3802, 2948
Trempealeau County, Wisconsin, 55121, 29412, 51077, 12764, 140800, 8603, 5182, 3421
Vernon County, Wisconsin, 55123, 30279, 47675, 13761, 140900, 9302, 5198, 4104
Vilas County, Wisconsin, 55125, 21355, 41061, 25330, 194900, 8070, 4289, 3781
Walworth County, Wisconsin, 55127, 103039, 53445, 51651, 189600, 27018, 18239, 8779
Washburn County, Wisconsin, 55129, 15700, 42368, 13022, 143600, 5557, 3092, 2465
Washington County, Wisconsin, 55131, 132921, 69237, 55303, 215400, 41284, 28733, 12551
Waukesha County, Wisconsin, 55133, 393873, 76545, 162095, 249300, 118321, 82764, 35557
Waupaca County, Wisconsin, 55135, 52125, 51994, 25478, 137300, 16187, 10230, 5957
Waushara County, Wisconsin, 55137, 24321, 45166, 14898, 137300, 7854, 4491, 3363
Winnebago County, Wisconsin, 55139, 169004, 52018, 74023, 143100, 44892, 29387, 15505
Wood County, Wisconsin, 55141, 74012, 48961, 34256, 120100, 23618, 14027, 9591
Albany County, Wyoming, 56001, 37565, 42834, 18537, 216100, 7591, 4596, 2995
Big Horn County, Wyoming, 56003, 11895, 51679, 5373, 141400, 3321, 1535, 1786
Campbell County, Wyoming, 56005, 48013, 80060, 19525, 212200, 12651, 8912, 3739
Carbon County, Wyoming, 56007, 15739, 56825, 8559, 146200, 4217, 2442, 1775
Converse County, Wyoming, 56009, 14101, 62307, 6478, 190300, 4229, 2535, 1694
Crook County, Wyoming, 56011, 7229, 60445, 3587, 205800, 2317, 947, 1370
Fremont County, Wyoming, 56013, 40755, 52773, 17723, 186500, 10875, 5534, 5341
Goshen County, Wyoming, 56015, 13544, 42689, 5952, 148700, 4124, 2254, 1870
Hot Springs County, Wyoming, 56017, 4809, 45278, 2571, 151600, 1621, 834, 787
Johnson County, Wyoming, 56019, 8600, 54065, 4532, 227700, 2623, 1418, 1205
Laramie County, Wyoming, 56021, 95431, 60706, 41256, 190000, 25632, 16716, 8916
Lincoln County, Wyoming, 56023, 18316, 66647, 9008, 201700, 5496, 3272, 2224
Natrona County, Wyoming, 56025, 80011, 56871, 35316, 185600, 21409, 13335, 8074
Niobrara County, Wyoming, 56027, 2516, 40398, 1321, 157900, 715, 346, 369
Park County, Wyoming, 56029, 28985, 56363, 13823, 221300, 8514, 4716, 3798
Platte County, Wyoming, 56031, 8750, 38500, 4691, 155500, 2893, 1465, 1428
Sheridan County, Wyoming, 56033, 29738, 55455, 14257, 228000, 8589, 5058, 3531
Sublette County, Wyoming, 56035, 10117, 81772, 5843, 275600, 2664, 1565, 1099
Sweetwater County, Wyoming, 56037, 44772, 69022, 19042, 190900, 11841, 6409, 5432
Teton County, Wyoming, 56039, 22311, 75325, 13146, 689000, 4953, 3156, 1797
Uinta County, Wyoming, 56041, 20930, 56569, 8765, 176700, 5480, 3018, 2462
Washakie County, Wyoming, 56043, 8400, 47652, 3819, 160800, 2590, 1470, 1120
Weston County, Wyoming, 56045, 7152, 57738, 3506, 178200, 2330, 1012, 1318
